chug - пыхтение, пыхтеть
vulture - стервятник, хищник (о человеке), гриф
alum - выпускник
highball - виски с содовой и льдом
skank (жаргон) - оскорбление, что-то вроде беззастенчивого грубого обмана
bust - неудача, провал; обанкротившийся; разрушать, ломать; женская грудь, бюст;
tenure - предоставлять постоянную должность; пребывание (в должности); владение недвижимостью (землей)
vat - бак, цистерна, чан
nosedive - пикировать, пикирование
berate - бранить, разносить, ругать
botch - заплатка, неумело латать или что-то делать
haunt - часто заезжать, навещать; часто навещаемое место
pervert - извращенец, извращать
menial labour
blab -  болтать
cushion -  диванная подушка; подкладывать подушку; обходить молчанием, опускать (какую-л. тему)
condolence - соболезнование, сочувствие
thrifty - бережливый, процветающий
vicarious - замещающий другого; чужой
besiege - осаждать
dangle - соблазнять, манить, увиваться; свисать, болтать ногами
edible - еда, съедобный
wallow - валяться; барахтаться; катание, валяние
elusive - неуловимый, ускользающий
blowback - отдача
vow - клятва...
rash - сыпь; поспешный, неосторожный;
cuff - одевать наручники; удар, бить
    cuffs - наручники
fall off the wagon - жарг. сорваться (напр. о нарках)
bomb - амер. потерпеть неудачу
piling up - накапливаться
trench
pummel - бить
do-gooder - благодетель
perky - бойкий, весёлый, наглый
yea - 
    yea high - вот такого роста
feline - кошка, кошачьий
distemper - волнения; приводить в волнение
duh - а то!
loath - делающий неохотно; не склонный; противный
shudder
bizarre - странный, неестественный
relapse - повторение, рецедив
celadon
conning - обманывать; эксплуатировать
consolation - утешение, утешительный
menace - угроза, грозить
heck - чёрт, к чёрту
frigging - проклятый, чёртов
commissary
limp - хромать, хромота; слабый
untenable - непригодный
disposable - одноразовый, доступный
ashram - монастырь (в Индии), приют, коммуна хиппи
severance - разрыв, растование, увольнение
billable
bounce
scorch
abetting - соучастие, подстрекательство
bond - связь, узы, свзывать, несвободный
veal - телятина
discretion
tether - привязь, привязывать
