lease - аренда, сдавать или брать в аренду
hit-and-run - быстрый; что-то относящееся к быстрой смене позиции
restitution - возвращение, возврат
archdiocese - епархия архиепископа
limo - лимузин
grudge - недовольство, злость; испытывать недовольство, испытывать злость
rerun - повторное что-то
vaporize - испарять, распылять
botch - заплатка, плохо латать; плохо работать, плохая работа
bungle - плохо работать, плохая работа
grease - масло, смазывать
preconception - предубеждение
reprimand - выговор, делать выговор
felicitation - поздравление
    felicity - счастье, блаженство
macabre - мрачный, относящийся к смерти
bleak - открытый (незащищенный); холодный, промозглый; жестокий
discern - распознать
demure - скромный, сдержанный, рассудительный
wayfarer - путник
amenity - приятность, вежливость, любезность
    for gest amenities
tranquil - спокойный, мирный
sinew - сухожилие, мускулы; усиливать
sinews - опора, поддержка, движущая сила
attorney - доверенной лицо; адвокат
habiliment - снаряжение, экипировка
yanking - дергание, дергать
clientele - клиенты
amiss - плохой, плохо; неправильный, неправильно
flinching - вздрагивать, дергаться
languish - слабеть
arrears - долги
bereave - отнимать, лишать
nifty - остроумно, остроумный; модный; ловкий
stitch - шов, шить
cereal - злаки, крупа
gumshoe - работать частным детективом; красться, резиновая обувь
dick - (амер) детектив
stead - помогать, польза, земельный участок, место
    steadfast partner
banter - добродушно шутить, добродушное подшучивание
decant - сливать, сливать жидкость
    decanter - графин
state-of-the-art - новейший
arouse - будить; будоражить
lustful - сладострастный, похотливый
seafarer - мореплаватель
footage - отснятый материал

deteriorate - ухудшать; портить
assess - оценивать
consent - согласие
construe - толковать (истолковывать)
freebie - что-то полученное задаром
liquor - выпивка, ставить выпивку
withhold - воздерживаться, удерживать, отказывать
deity - божество
minion - прислужник, любимец
carnal - плотский
alley - алея, узкая улица
accord - согласие; оказывать (предоставлять что-то)
    accord with - гармонировать
overbred
hooch - выпивка; лачуга
encompass - окружать; заключать прям. и перен.
    - в т.ч. как делать вывод
veneration - поклонение
payroll - платежная ведомость; фонд заработной платы
amalgamation - смешение
    amalgam - смесь
exquisite - изысканный
suffocate - душить
adversity - бедствия, неприятности, неблагоприятная атмосфера
pliers - щипки
damp - ослаблять, останаваливать; ослоблятель, останавливатель
    - влажный, влажность, увлажнять
thug - убийца; головорез, бандит

