comin
swagger - ходить с важным видом (с качающейся походкой); манера держаться самодовольно или развязно
sumptuous - роскошный; дорогостоящий; богатый
conventional - обычный
calf
vainglorious
spiteful - злой, злорадный
thrive - процветать
attorney
vigilante - что-то вроде друженника?
    vigil - бодрствование; дежурство
pew - церковная скамья
ogle
belie
intangible - неосязаемый, неуловимый; неуловимое, непостижимое
uncouth -  грубый, неотёсанный;  безлюдный
shawty - малышка (красивая девушка)
svelte - стройный
stature
wagwan - здорово! (жарг)
clot - сборище?
tussle
invincible
cape
parole - досрочное освобождение
loophole - лазейка
perpetual
holler

abalone - раковина
up close - вблизи
dime - монета в 10 центов
varsity
perp
fumigate
fund(-)raiser
surveillance
peddling - торгующий мелочью, торговля мелочью
    peddle
quibble - придирка, придираться;
vex - досаждать, раздражать; возмущать
chalk - мел, рисовать мелом, натирать мелом
joint - общий, преступное сообщество (банд.), сустав, узел, стык
fella - любовник
siddity
bougie

hokey
scripture

mescal - мескалин
dribble - капля, небольшое количество; струйка, маленький ручеёк; капать, течь тонкой струйкой
congregation - скопление; собрание, сходка
turf - дерн, торф; выстилать дерн
turf - (жарг) район контролируемый бандой
consternation - ужас; испуг; оцепенение (от страха)
elope - сбежать; бежать
lame - калека, калечить; неправильный, слабый (отговорка) и т.д. много смыслов; 
sorority - сестринство
docile - послушный, покорный; восприимчивый, понятливый
hungover - похмелье
concuss - трясти; запугивать
bodega - винный погребок
rehab - реабилитация, ремонт
precipice - обрыв, пропасть
abuzz - гудящий, жужжащий, энергичный
insulate - изолировать
stoke - поддерживать огонь; забрасывать топливо; топить
sublet - передавать в субаренду
crib - лачуга; (жарг.) дом; детская кроватка; у слова много разных других значений
expunge - вычёркивать, удалять; уничтожить
craftsmanship - искусство, мастерство, умение
flunkey - лакей, подхалим
	flunk - 
precarious - ненадёжный

the survival of the fittest - выживание наиболее приспособленных, естественный отбор
maul - сильно ударять, наносить сильный удар; избивать; (усн) сильный удар; подвергать критике
evaporate - испарять, испаряться
exonerate - освобождать (от ответственности, обязательств); восстановить репутацию (и подобное)
centrepiece - центральный предмет
prosthesis - протез
    prosthetic - протезный
gig - ...много значений..., но в тут наверное было использовано "работенка"
gal - девчонка
dip - макать, окунать; окунание, макание; ныряние
