all the way - полностью, до конца
mole - дамба
gauge - измерительный прибор
stern - зад (хвост, корма); строгий, суровый, мрачный
down here - до сюда
keep 'em - ???
gangplank - трап
barrage - заграждение, ставить заграждение
barrage - шквал огня (в том числе огнестрельного)
rudder - руль, рулить
    в том числ хвост (рыбы), лопасти и т.д.
rear - воспитывать, растить
    - зад, задний, расположенный сзади; тыловой
rear admiral - контр-адмирал
rearguard - арьергард
deck - палуба, настилать палубу
starboard - правый борт, справа по борту
bail - брать на поруки; заклад, залог; поручительство
bail out - выручать из беды, срочно покидать транспорт (напр. прыгать с парашютом)
ditch - рыть канал или ров; канал, ров
capsize - опрокидывать (транспорт?)
pier - волнолом, плотина
Highlander - шотландские горцы (еще и название связанных с этим войск)
requisition - требование, требовать; предписание, изымать
vanquisher - победитель; покоритель
aground - сидящий на мели (в широком смысле)
scarper - сматываться (напр. убегать)
sod - проклинать (посылать к черту), сволочь
oi - эй
chute - парашют; какой-либо вид ската (как горка)
daft - дурацкий (в том числе человек, в смысле придурковатый или глупый)
sauerkraut - кислый или квашеный
decency - приличие
bowel - внутренний орган, кишка, сострадания (мн. ч.)
regimental - полковой
farrier - ковочный кузнец; коновал (знахарь, лечащий лошадей)
tiller - рукоять или рычаг (напр. руль корабля)
fry - мелкая рыбка; жарить
deliverance - спасение, освобождение
