reel - катушка, мотать
disdainfully - презрительно
	disdain - пренебрегать, презирать, пренебрежение, презрение
posture - осанка
leery - осторожный, ловкий, хитрый
tracing - чертеж
vague - нечеткий, неясный
hourglass - песочные часы
shallow - мелкий, отмель
extricate - выводить, вытаскивать, находить решение (выходить из трудной ситуации)
mingle - смешивать
ripple - рябь, покрываться рябью; маленькая волна, струиться
prick - укол, шип
	prickly - шипастый
mildly - мягко, спокойно
scowl - сердито смотреть
urge - порыв, порываться, подгонять
touchy - раздражительный, обидчивый, чувствительный
placate - умиротворять, успокаивать
prank - проказа, шутка
hive - улей
scent - запах
frenzy - неистовство
hazing (жаргонное) - испытание
brag - хвастовство, хвастаться
prominent - выступающий (о положении в пространстве), заметный
covet - жаждать
spacious - обширный
workshop - мастерская
usher - пропускать, консьерж
flat out - прямо, открыто, просто
concoct - состряпать
aggravate - усугублять
beforehand - преждевременный, заранее
plausible - правдоподобный
chuckle - тихо смеяться, тихий смех
brat - надоедливый ребенок
threshold - порог, преддверие, вход, врата
utter - абсолютный, определенный; произносить (что-то)
outline - очертание, контур
feat - подвиг, искусный, мастерство
deciding - решающий
lurk - прятаться, красться, слежка
opt - выбирать
scrutinize - внимательно смотреть
inclined - расположенный, предрасположенный, наклоненный
	I am inclined to agree
impersonator - актер, самозванец
	impostor - самозванец
raging - вышедший из под контроля, выходить из себя, мощный
whim - прихоть, каприз
low-key - незаметный, слабейший (как второстепенный?)
sliver - кусочек
dilation == dilatation - растяжение
eve - канун
oblivious - не замечающий, забывчивый, не помнящий
solemn - торжественный, священный
upturned - вздернутый
tine - острие
unnerve - ослаблять, лишать присутствия духа
unimpeded - беспрепятственный
haphazard - случай, случайный
prod - тычок; тыкать, колоть
regimen - режим, управление, форма правления
decline - отклонять, спускаться, падать
grim - жестокий

condescension - снисходительность
crippled - хромой
scoff - насмешка, насмехаться; жадно есть; грабить
bicker - спор, спорить, ссора, ссориться
	bickering - спор, ссора
repulse - отпор, отбиваться (атаку); отказ
terrain - территория, топография
incursion - вторжение, нападение
corpse - труп
predecessor - предшественник
crave - жаждать; просить, умолять
coalescence - сращивание, слияние, объединение
rout - бегство, разрушать
interior - внутренняя часть, внутренний
perished - погибший, пропавший (исчезнувший или испортившийся)
cripple - калека, получать травму
turmoil - суматоха
arm-twist - оказывать давление (не физическое)
revolt - бунт, бунтовать
obstacle - помеха, преграда
smug - самодовольный; ...
swoop - внезапное падение, налет
incense - гневаться; ...
mutiny - мятеж, бунтовать
grimace
whatnot - что-то еще из вещей
dense - плотный, густой
infest - кишеть, наводнять
swathe - бинт, бандаж; бинтовать
swath - просека
drake - селезень, муха-наживка
devour - жадно есть, поглащать
mantis - богомол
howler - ревун, плакальщик
thorn - шип
wreck - крушение, развалина; терпеть крушение, рушить
	wrecking - разрушение, снос, демонтаж; разрушительный, спасательный
fledged - оперившийся, способный летать, готовый (к чему-то)
outright - полный, совершенный, прямоленийный
biased - предвзятый, фанатичный, необъективный
vent - входное отверстие, делать отверстие
stomp - топать
apt - подходящий
weathered - выветренный
obstacle - препятствие
criss(-)cross - пересекающийся
dim - тусклый, темнота, темнеть
foliage - листва
tangle - спутанный клубок, путаница, путаться
ignite - воспламенять
stray - заблудившийся (adj & noun), заблудиться
nepotism - кумовство
compunction - сожаление
glittering - сверкающий
verge - грань
boon - дар, доброжелательный, щедрый, благо, покровительство
seasoned - опытный, бывалый
stance - поза
burly - крепкий ( сильный )
cranium - череп
scry - гадать на магическом кристале
noteworthy - заслуживающий внимания
contraption - хитрая штука, хитрое изобретение
reminiscent - напоминают (-ющий)
petal - лепесток

subvert - повергать
puppeteer - кукловод
shortage - нехватка
wince - вздрагивание, вздрагивать, морщиться
eavesdropper - подслушивающий
shrewd - проницательный, сообразительный
fumble - мять, мяться, нащупывать
bluntly - прямо
	(told her bluntly - сказать напрямик)
sedate - спокойный
defuse - разряжать
fawn - ласкать, ...
preconception - предубуждение
innate - врожденный, присущий
sheer
peon - пехотинец, строго подчиненный человек
entourage - окружение, антураж
hefty - тяжелый
malfunction
cenote
induce - побуждать
blunder - грубая ошибка, грубо ошибаться
brazen - медный, быть нахальным
reptile - рептилия, подлый
projectile - снаряд, метательный
imminent - надвигающийся, неизбежный
nimble - ловкий
seizure - захват
plume - перо, пух
throe - сильная боль, спазм
pounce - коготь, хватать когтями
devoid - лишенный
scattered - разбросанных в беспорядке
veer - смена направления, менять направление
slam - хлопать, захлопывать
flail - молотить, цеп
dislodge - выгонять, вытеснять
hiss - шипеть, шипение
outrageous - оскорбительно, возмутительно
dissuade - разубеждать, отговаривать
pitiful - плачевный, жалостливы
villain - злодей
dwelling - желище
gleeful - радостный
unfold - раскрывать
salivate - выделать слюну
battering - избиение
gust - порыв, дуть
gaunt - костлявый, мрачный
retaliation - воздояние
scramble - пробираться, драка
roughly-hewn
wreathe - обвивать
impale - прокалывать, сажать на кол
slay - убивать, уничтожать
shard
liquefy - плавить
semblance
cohesion
brethren - собратья
dissolving - растворение, растворяющий
drove
vain - 
sprung - треснувший
spectral - призрачный
momentum - импульс
resembling - аналогичный
meddle - заниматься чем-то, вмешиваться, совать свой нос
potent - могущественный, эффективный
uncoil - разматывать
blunt - тупой, притуплять
motes - пылинка, соринка, холм, курган
conjure - показывать фокусы, вызывать заклинание, заклинать
tackle - инструмент, делать что-то с усердием
wrestle - бороться, борьба
unerring - безошибочный
furnace - горн, очег, печь
incineration - сжигание
lance - копье, метать
spar
copious - обильный
translucent - полупрозрачный
slime - что-то липкое, покрываться липким
bent - наклонный, изогнутый
graze - задевать, тереть, царапать; задевание
begrudge - жадничать, завидовать
grievously - печально; мучительно
gloomy - мрачный
surmise - догадка, догадываться
plop - плюхание, булькание, плюхать, булькать
unmarred
snort - храпеть
derisively - иронически, саркастически
slumber - сон, спать
whereas - тогда как
mercenary - наемник, нанятый, торгашский
avert - отворачиваться, отвращать, предотвращать
unassailable - неприступный
boar - хряк
amok - быть не в себе, быть безумным
irate - гневный
resilience - устойчивость, гибкость
grunt - хрюкать, хрюканье, ворчать, ворчание
groan - стон, стонать
wraith - дух, как-то связанный со смертью
outbreak - внезапные вспышка, шум или что-то подобное; выброс чего-то
	popular outbreak — народное восстание
decimate - взымать десятину, казниц каждого 10го, казнить
snarl - рык, рычать; ворчание, ворчать
slit - прорезь, делать прорезь
wrench - выкручивание как вырывание, выкручивать (напр. мучить)
unmolested - оставленный в покое
lasting - длительный
pat - хлопок
dismissively - пренебрежительно
sway - взмах, колебание; колебать; власть
merited - заслуженный
bandy - обмениваться, обсуждать
subdued - подавленный, подчиненный
digest - 
chasm - раздор, трещина
jag - зубец
askance - косо, наклонно
audacious - бесстрашный
squirm
falter - спотыкаться
inane - пустой, свободный
smuggle - тайно провозить или проносить
insidious - хитрый, коварный, действующий тайно
countermeasure - контрмера
intact - нетронутый
shrill - пронзительный, пронзительно
centipede - многоножка
jellyfish - медуза
bludgeon - дубинка, бить дубинкой
pinprick - мелкий укол, досадная мелочь
crescent - полумесяц, растущий (часто о луне)
distortion - искажение
vicinity - близость, соседство, окрестность
rubble - валун, каменная кладка
vicious - порочный, злой, плохой
bolster
spook
insurmountable
zeal - рвение, старание

