unit 1

barbecued
barrier
beggar - попрошайка, доводить до нищеты, превосходить
begging - нищенство
birth family - биологическая семья
cheers - ваше здоровье!
crisp - хрустящий/рассыпчатый
		- жесткий
		- лаконичный
		- покрытый настом
determine - определять, решать
drop in - зайти, вклиниться
fall asleep
fans - фанаты?
fateful - пророческий, роковой, важный (судьбоносный)
feel up to smth - быть в состоянии для ...
fend for himself - постоять за себя
	fend - предотвращать
fortnight - две недели
fortune teller - предсказатель
foul play - подлая игра
	foul - грязный, грязное
freak - чудить
get it - понимать это, получить нагоняй
get the better of smth - победить кого-то
granted
	to take for granted - принимать как должное
grab == grasp
hang out
have a lot on - иметь много всего в
	I just have a lot on my mind. - У менять просто много всего в голове.
heartbroken - убитый горем
hit on - совпадать по (какому-то признаку), (попадать в цель при поиске)
home-grown - (один из переводов оскорбление доморощенный???)
homecoming - возвращение домой
hometown
hop in - запрыгнуть
host family
house-bound - привязанный к дому
house-proud - создающий уют
housewife
illiterate - неграмотный
kind of (weird) - 
life expectancy - продолжительность жизни
life insurance
life-size - в натуральную величину
lifelong - пожизненный
lifestyle
likes - симпатии???
Lucky you!
make a living - зарабатывать на жизнь
load of - нагрузка чего-то, много чего-то
motorbike
mousse - мусс
nap - дремота, дремать; ворс
notorious
orphanage - сиротский приют, сироты
pass away - исчезать, проходить
plays - игра, пьеса
railway track
raindrop - дождевая капля
recognize
salesman - продавец
settled down - обосновавшийся
shelling - обстрел
shells - патроны
sleeping rough - спящий на улице
slum - трущоба
stress out - подчеркивать
	I want to stress this out
struck gold - нашел золото
	struck - столкнулся, от strike
sweeper
swing it - 
tourists
unbelievable
vivid - яркий
wandering - блуждающий

unit 2

at stake - поставить на карту
backpacker - пеший турист
best-selling
bike ride
biodegrade
choking
clogging - 
	clog - засорять (засорение? засоряли (мешали))
coastal - береговой
	coastline - береговая линия
combs - комбинация
consequences
countless
culprit - виновный, преступник
debris - обломки
decade
devastating - опустошительный, потрясающий
do away with (something) - разделаться с ...
extensively - сильно
filler
fleck - пятно, покрываться пятнами
get down to business - взяться за дело
gobbled up - жадно глотать
	gobble - глотать
jute bag
	jute - джут
lethal
loss - потеря
make the big time - добиться успеха
maze - лабиринт, путаница, приводить в замешательство
merchant - торговец, коммерческий
misleading - обманчивый
mouldings - отливка
mugged - ограбленный
must-see
nurdle
obscenity - непристойность
ouch - ой
outskirts - окраина
	outskirt - граничить
outstanding - выдающийся (напр. писатель), торчащий
overboard - за борт
overland - по суше, сухопутный
parkland - парк
partying
pellet - шарик, катышек, делать катышек
Pharaohs - фараоны
pleased with (smbd)
pristine - древние, изначальный
roadworks - дорожные работы
sat nav - спутникавая навигация
scuba diving
	scuba - акваланг
second thoughts - пересмотренные соображения
self-catering
	catering - ресторанное обслуживание
set off for (somewhere)
sloshing - хлюпанье
soiling - загрязнение
spine - хребет, основа
spurn - отвергать с презрением, презрительный отказ
staggered
stroll - прогулка, прогуливаться
stung - прош. время от sting
sushi
swirling - кружение
terrace - терраса
throwaway society
	throwaway - одноразовый, расточительный
tourist spots - туристические места?
trade link
travel bug
turquoise - бирюза
uneventful

unit 3

alighted
	alight - выходить
		to alight at a station — выходить на станции
	alight (with) - горящий
		The sky was alight with stars. — В небе горели звёзды.
ambulance - скорая помощь
anchorage - якорная стоянка
avalanche - лавина
cameraman - фотограф
character trait
	trait - черта
clinging
	cling - цепляться
clutch - захват, хватать/сжимать
cons
constituent - компонент, образующий
disbelief - недоверие
drift - гнать, смещаться, перемещение
dull - тупой (в т.ч. глупый), притуплять, оглушать
dummy - макет
elk - лось
emaciated - истощенный
feebly - слабо
gossip - сплетня, болтать
haunted - посещаемый (в т.ч. приведениями)?, испуганный
in connection with (smth) - в связи с
incident - инцидент, свойственный
lay bare (smth) == reveal (smth)
limelight - свет в театре (друммондов свет), цент внимания, быть в центре внимания
lure - соблазн, приманка, завлекать
newly build
	newly - вновь
nutrition - питание
overcoat - пальто
overhead - надземный
page-turner - абстрактно, как изменяющий со временем???
play (something) out - сыграть (это) 
	I had to play it out
plunged
	plunge - нырять, погружение
poor state
possessiveness - собственничество
property tycoon
	tycoon - магнат
safety precaution
	precaution - предосторожность
scrape - скрести
sensuous - чувственный
sinister - злой
snowmobile - снегоход
speculation - размышление, спекуляция
stench - вонь
stunt - трюк, проявлять ловкость; остановка в росте, останавливать рост
stuntman - каскадер
sublime - величайший, великое
synopses - краткое изложение, конспект???
tenants
	tenant - наниматель, нанимать
top of her class - лучшая в своем классе
towed - протянутый
	tow - трос
	tow - тянуть
transcend - переступать пределы
	transcendent - за пределами (сущ)
What a drug! - ничего себе!
windscreen - переднее стекло, ветровое стекло

unit 4

arbitrary - произвольный
atheist
authentic
bearable - сносный
blissful - блаженный
	bliss - блаженство
Bon appetit!
breathtaking - захватывающий
breeds - род, племя; размножаться
bungee jumping - штука с пружиной на которой прыгают
	bungee - пружинный механизм?
credible - надежный
diehard - жизнестойкий
dyslexic - дислексик
farce - фарс; фарш, фаршировать
fiendish - демонический
fluttering
	flutter - дрожание, махать
hatched - заштрихованный
hoax - обман, разыгрывать
hypotheses == hypothesis - гипотеза
implausible - невероятный
insomniac - человек страдающий бессонницей
it suits you - это тебе подходит
justified
	justify - оправдывать, доказывать
loathe - чувствовать отвращение
	He loathes working.
lousy - вшивый
	to be lousy with — кишмя кишеть
mundane - мирской, светский
naturist
plausible - благовидный
probable - вероятный
scalding - жгучий, обваривание
squashed - раздавленный
stranded
	strand - прибрежная полоса, садиться на мель
tampered
	tamper (with) - подделывать, портить
	to tamper with a document
teetotaller - трезвенник
thick - жирный, густой; чаща, пекло, разгар
unanimously - единогласно
	unanimous - единогласный
unsuspecting - доверчивый
urgent - срочный, неотложный
white lie - невинная ложь, ложь во спасение

unit 5

a good talking to - хороший выговор в связи с ...
against the odds - вопреки всему
apps - дополнения, приложения
aspect - аспект, выражение лица, направление
	humorous aspect — забавное выражение лица
	The house has a southern aspect. — Фасад дома выходит на южную сторону.
aspiration - сильное желание достичь чего-то
burden - груз, грузить
	burden with - обременять ...
conscientious - сознательный, честный
council estate - муниципалитет
	estate - поместье, имение, имущество; положение в обществе
cruising speed - крейсерская скорость
draw attention to - обратить внимание на
dreadful - ужасный
entrepreneur - предприниматель, владелец цырка
exploit - деяние, эксплуатировать
fatigue - усталость, утомлять
hang about - слоняться
jamming session
landing card
make a success of - приходить к успеху (в чем-то)
mentoring
my pleasure - мне очень приятно
overrun - перерасход, переходить пределы
primarily - первоначально
put your foot in it - сглупить
	I've really put my foot in it this time. I didn't realize that was her husband!
reconcile - мирить
rugby
scared stiff - сильно перепугался
	stiff - жесткий, крепкий
sitting up
	sit up - сидеть выпрямившись
skim-read
	skim - скользить
	skim milk — снимать сливки с молока
sponge cake - бисквит
sulk - плохое настроение, быть в плохом настроении
torchbearer - факельщик (дословно), вдохновитель
turning point
variety - многообразие, различие
vision - зрение, проницательность
	man of vision — проницательный человек
wheelchair - инвалидная коляска
placement - помещение, определение на должность
	placement agency — агентство по найму
	
unit 6

ailing - нездоровый
appeal - призыв
attachment - привязанность
bitterly
burgled
	burgle - красть со взломом помещения
catering college
	catering - ресторанное обслуживание
comfy == comfortable
drop out of - выпадать из (напр. бросить учебу)
dustman - мусорщик
employee welfare - соц. обеспечение, благосостояние трудящихся
	welfare - благоденствие
enthusiasm
expand - растягиваться в размере, увеличиваться
fattening - ?
	fatten - делать более питательным
fierce - жестокий
hold-ups
	hold-up - вооруженное ограбление, задержка
irresistible - неотразимый, непреодолимый
lounge - гостинная
make it big - разбогатеть, добиться своего
network - сеть
numerous - множественный, гармоничный
offhand - импровизированный, грубый
out of curiosity - из любопытства
overnight success - неожиданный успех (проснулся после ночи успешным)
	overnight - происходивший накануне вечером или ночью
overwhelmed
	overwhelm - ошеломлять
point and click graphics
policy - политика
profitability
sleek - гладкий, лоснящийся
tribute - дань
vicar - приходской священник
vitally - жизненно важно
zipping - ?

unit 7

affair - дело, случай, любовный роман
alongside - рядом
appropriate - подходящий
arranged marriage - запланированный брак
call up - вызывать/призывать (основные значения); звонить по телефону, призывать на воинскую службу
	I called him up - Я позвонила ему по телефону
	call up memories - вызывать из памяти (вспоминать)
beneficial - выгодный, благотворный/целительный
chaperon(e) - сопровождать/сопровождающая, компаньЁНКА
charge - зарядка/заряжать, цена, подопечный/попечение, обвинение/обвиняемый, атака
clue - абстрактный ключ, моток, улика, нить суждения
contribute - вносить, способствовать
correspondence - соответствие
	correspond - соответствовать
designated - объявленный, определяемый
	designate as - определять как
	designate for - предназначать для
engagement - встреча, свидание, обязательство
environmentally friendly - дружественный к окружающим
erode == destroy
exaggerated
	exaggerate - преувеличивать, увеличивать
flood (фладс)
forfeit - штраф, поплатиться чем-либо, проиграть
haunt = pursue == chase
impersonal - безличный
knackered == exhausted, кстрированный (о животном)
	knacker - живодер (стукальщик молотком для убоя???)
know-how - умение
lax - слабый, лосось/лососевый
means - средство, способ
matter - вещество, материал, вопрос/причина/основание
	matter - иметь значение
	mattering wound — гноящаяся рана
	as a matter a fact
outweigh - перевешивать
perks - привилегии, кофе/варить кофе, побочный доход
	perk up - поднимать (часть тела, дух, уровень красоту)
permitted
	permit - разрешать
respond
	respond to - отвечать на
(for the) sake (of) id
snail - улитка
sponge - губка, работать губкой
spontaneous
strapped - связанный
stated - заявленный, установленный
subtle - тонкий (искусный)
titbit - лакомый кусок
tuition - обучение
	tutor - репетитор
understated - не заявленный, заниженный
	understate - приуменьшить
wits - разум, остроумие
worship - поклоняться

ageing - старение
cast my vote - проголосовать, поделиться мнением
commitments - обязательства
crazy about - без ума от
cultural values - культурные ценности
denial - отказ
designated area - обозначенный район
fond - нежный
madly in love - безумно влюблен
miraculously - чудным образом
mutter - бормотание, бормотать
not keen on - не в восторге от
out of breath - запыхался
out of order - не в порядке
paid-up - оплаченный
passionate - страстный
refusal - отказ
sake of smbd
shrug - пожимать (плечами)
sizeable - порядочного размера
spoilt for choice - избалован шансом?
thick as planks - тупой как пробка
	planks - планка, доска, класть доски
understatement - преуменьшение
well off - состоятельный
youth - юность

-------------
disapprove - осуждать
mild - мягкий
bound - граница, скачок
packed - заполненный/забитый (напр. вагон)

bound up with - связанный с (чем-то)
bound up in - быть занятым в (чем-то)
confide in - верить в
confide to - вверять что-то
look up in - искать в
look up to - уважать кого-то
	looking up - улучшается (состояние)

unit 8

adjacent - расположенный рядом
afterthought - запоздалая мысль
authorities - власти
beyond description - чрезвычайно
bonfire - костер
bullies - хулиганы
co-star - актер-звездна совместно с кем-то
comforting - утешительный
competitive - соперничающий
completely - вполне
conceited - самодовольный
	conceit - самомнение
conservancy - охрана природы
downpour - ливень
hard luck story - жалостливая история
	hard luck - неудача
laughing matter - повод для шуток
listed building - историческое здание
marvelous == marvellous - изумительный
	marvel - чудо
nostril - ноздря
profusely - обильно
	profuse - обильно
pruner - подрезчик дерева, секатор
real estate agent
	real estate - недвижемое имущество
self-important - с большим самомнением
skyline - горизонт
split-level home
	split-level - на разных уровнях
thank goodness - слава богу
workmanship - мастерство
worn - потрепанный

unit 9

auction - аукцион
big-headed - заносчивый
bloke - парень
blouse - блузка
boiling-hot - ужасно жарко
bored stiff - сильная скука
brand-new - совершенно новый
breadwinner - кормилец
bygone era
    bygone - прошлый, устаревший
clumsy - неповоротливый, невоспитанный
cosy - уютный
council worker
courtship - ухаживание
cutlery - столовые приборы
dead easy - просто
distressing - печальный
ecstatic - в экстазе (noun)
flat cap - плоская крышка
	cap - шапка, крышка, одевать шапку
fridge freezer - холодильник с морозилкой
gone to a lot of trouble
    We've _gone to a lot of trouble_ here with these broadcasts
        - много проблем
    You've _gone to a lot of trouble_ to meet me.
        - много усилий
halcyon time - тихие времена
hours on end - часов подряд
like-minded - единомышленник
marking time - топтаться на месте
meet up - встретиться
mod cons - современные удобства
nosy - с хорошим нюхом, носатый
opposing views - противоположные мнения
ordeal - жестокое испытания
pantry - кладовая
patronized - опекаемый
pencil skirt - узкая прямая юбка
pinny - передник
quaint - чудной привлекательный
re-creation - имитация
revolves around - крутиться вокруг
school reunion - встреча выпускников
seaside - побережье
self-obsessed - самовлюбленный
sing-song - спеть песню
sitting room - гостиная
solely - единственно
sound asleep - крепко спать
teased - дразнили
top hat - шляпа цилиндр
twee - свистящей звук; изысканный
waistcoat - жилет
wasteful - расточительный
wide awake - бодрствующий

unit 10

ammunition - боеприпасы, оружие, защита (все военное)
atrocity - жестокость, жесть
bead, beads - шарик, бусы, бисер
buffalo - буйвол, пугать, сбивать с толку
childminder - няня
clash - лязг, сталкиваться
encountered
	encounter - встретить, встреча
ensued
	ensue - происходить
face the fact - считаться с фактом
finding my feet - встать на ноги???
flared
	flare - вспышка, вспыхивать
foible - слабость, часть клинка от середины до конца
goes to their heads - ударило/пришло им в голову
hazardous - опасный
heart-to-heart
hostility - враждебность
hostilities - военные действия
impassable - непроходимый
livestock - домашний скот, паразиты
manual skills - мастерство ручного труда
mosquito
on its last legs - на последнем издыхании
overcome - преодолеть; изнурять; овладеть
plague - эпидемия, заражать, изводить
putting on a brave face
scarce - недостаточный, дефицитный
tamed
	tame - прирученный, приручать
tension - напряжение
wilderness - дикая местность

unit 11

alimentary tract - пищеварительный тракт
auditory - слуховой
bearer - носильщик
bookcase - книжный шкаф
cable - канат, кабель; привязывать
catchphrase - популярная фраза
denomination - обозначение
densely - густо, плотно
devise - изобретать, разрабатывать; завещание
doing the rounds
earworm - прилипчивая песня
excreted
	excrete (vb) - выделять, извергать
follicle mite - железа
	mite (маит) - клещ, маленькая вещь, лепта
genius - гений, дух
	the genius of the time — дух времени
globe - сфера, иметь форму сферы
grin - скалиться
groans
	groan - стон, скрип; стонать, скрипеть
hairbands - резинка, обруч и т.д. для волос
harmless - безвредный
	harmlessly - безвредно
helpline - телефон доверия
host - куча; толпа; хозяин; принимать гостей, быть хозяином
in the wake of (smth) == in the wake of smb - по пятам
	wake - след
leap year
meme
mindboggling == mind-boggling - потрясающий
	boggle - изумлять; колебаться
monk - монах
multiplies (малтиплайс)
munch - чавкать
painstakingly
	painstaking - старание, старательный
pathway - тропа; траектория
pet - домашнее животное; любимец
	pet son — любимый сын
	pet name — ласковое имя, прозвище
puzzle over - ломать голову
robust - крепкий, здоровый; сильный
scrap - обломок (кусок), отправлять на слом; драка, драться
soundscape - звуковое окружение в которое погружаются
susceptible - восприимчивый, впечатлительный
tedious - нудный, утомительный
tolerate - допускать, терпеть
transcribed
	transcribe - переписывать

Unit 12

afterlife - загробная жизнь
basics - основы
beautician - косметолог
bits and pieces - разные мелочи, обрывки
break the ice - сломать лёд ( как в рус.)
centenary == century - век, 100 фунтов веса
cerebral abscess == brain abscess
	cerebral - мозговой
	abscess - гной
committee - комиссия, куратор
degree course - курс обучения для получения степени
dress rehearsal - генеральная репетиция
elderly - пожилой
en route - по дороге; в пути
enroll - становиться членом группы, вносить в список
exhilarating - веселящий, бодрящий
follow on (smbd's) footsteps
follow my nose - положиться на чутье
	I should follow my nose.
frantic - яростный (в ярости)
getting me down
healer - целитель
horrendous - страшный
I got the bug - подцепить, подсесть (в т.ч. на наркоту)
	I got the bug. - Я подцепил заразу
it hit me like a ton of bricks
ladybird - божья коровка
late developer - ребенок с запоздалым развитием
leisure time
lunacy - безумие, лунатизм
national assistance - государственная помощь
old bat - зануда, старый ворчун, карга
overpowering - непреодолимый, неотразимый
pavements - тротуар, мостовая
peace and quiet - тишина и спокойствие
poring - размышляла, изучала
	pore - изучать, обдумывать
	pore - скважина
	pore - пора (кожи т.д.), пустота (пористое что-то)
prioritize - отдавать предпочтение
ripen - созревать, делать зрелым
rottenly - мерзко
	rotten - гнилой
scandalous
snatch - хватание, хватать
stand on my own two feet
strawberry - клубника
such a pain - такой занозой
	You are such a pain
vital - жизненно
