unit 1

unit 2

abroad - всюду, за границей
accent - акцент, ударение
accident - несчастный случай, катастрофа
act the part - играть роль
almost - почти
always - всегда
at least - по крайней мере
at the moment (= now) - сейчас
awful - ужасный, отвратный, внушающий страх
bedtime - время ложиться спать
boss - хозяин, шев, выпуклость, промах
bring - приносить, заставлять, убеждать, выдвигать
celeb (celebrity) - знаменитость
clear up - убирать, прояснять, проходить (о болезни)
coast - побережье, граница, горизонт
communication - передача инфы, общение
competition - соревнование, соперничество, спор
contact lenses - контактные линзы
conversation - беседа, неформальный разговор
disadvantage - неудобство, ущерб
distance - расстояние, дистанция, отдаленность
divide - делить, разделять
divorced - разведенный
do overtime - работать сверхурочно
dormitory - общая спальня, общежитие, спальный пригород
employ - нанимать на работу
essential - внутренний, присущий, важнейший
European - европейский
exchange - обмен, биржа, перепалка
exhausting - утомительный
factory - фабрика, завод
farmhouse - фирменный дом
First things first! - перво-наперво
flat - плоский, квартира
glamorous - обоятельный, эффектный
Guess what! - знаешь что
guest - гость
hairdresser - парикмахер
a handfull - горсть
have something in common - есть что-то общее
hundred - сто
hurt - боль, обида, вред
impossible - невозможный
interested
just - только что
keep (us) busy
landscape - пейзаж, ландшафт
lifestyle
lonely - одинокий
loft - чердак
lucky
make-up - структура
manicure
mess - беспорядок, грязь, питание за общим столом
miss - девушка, промах
monthly - месячный
nail - ноготь
national park
never
occupation - занятие, проффесия
often
pearl
politician
poster
practise
prefer
private
province
racing
rent - арендная плата
robot
rooftop - крыша, поверхность крышы
routine - рутина
sale
send
sip - сербать
situated - расположенный
skills
social life
society
sometimes
strange
surprise
technology
test
text
That's really kind of you. - действительно мило с вашей стороны
tiring - утомительный
transatlantic
trendy - модный
twins
uniform
useful
usually
view
view of
voice
wage - заработная плата, залог
wear (your hair) - носить
wonderful
worst

unit 3

air-conditioning - кондиционер
aloud - вслух
amazed - удивленный
angrily - злобно
angry (with sb) - злой на кого-то
apartment - квартира
apologize - извиняться
appointment - назначенная встреча
assassin - убийца (политический)
bang - взорвать, стукнуть
big spender - транжира
bowl - глубокая миска
break into - ворваться
breathe - дышать
bullet - пуля
burglar - грабитель
cage - клетка
canal - канал (для воды и т.д.)
capture - захватить
carefully - осторожно
connection - соединение
copy
credit card
crept - ползти, пресмыкаться
crime - преступление
curse - проклинать
curtain - занавеска
date
destroy - разрушать
documentary - документальный фильм
downstairs - вниз по ступенькам
dream - мечтать, увидеть сон
engrave - графировка
exactly - точно
feel ill - чувствать больным
felt - почувствовать
figure - фигура, цифра
fill - заполнить
fortunately - к счастью
ghost - призрак
golden - золотой
gradually - мало по малу
guiltily - виновато
gunman - стрелок
happily ever after - долго и счастливо
heavily - тяжело, интенсивно
hide - прятаться
hit man - террорист
HQ (= headquarters) - штаб квартира
hungry - голодный
immediate - незамедлительно
invitation - приглашение
joke
knock on the door - постучать в дверь
laugh - смеяться
lazily - лениво
lead - вести за собой
let out - выпускать
lock - замкнуть
lorry - грузовик
lose - терять
lovingly - нежно, с любовью
marks - оценки
mend - ремонт
message - сообщение
midnight - полночь
missing - пропущенный
movement - движение
museum - музей
mystery - тайна, загадка, мистика
nervously - нервно
noise - шум
original - оригинальный
outside - снаружи
passport
peacefully - мирно
perhaps - возможно
pick up - снять
poem - стих
point - указывать на
pocker - покер
portrait - портрет
printer - печать
prison - тюрьма
pull - тянуть
quietly - тихо
refuse - отказываться
relief - облегчение (от груза)
reporters - репортеры
run out of - заканчиваться (бензин, чернила)
sadly - грустно
secret agent - секретный агент
security guard - охрана
shine - светить
shoot - стрелять
softly - мягко
spending spree - рост расходов
staff - персонал
stand up - встать
steal - украсть
still - всё ещё
straight - прямо
suddenly - внезапно
supper - ужин
switch off
teenager
terrorist
thief
throw - бросать
thump (of the heart) - удар (сердца)
tile - заглавие
together - вместе
tragically - трагично
translation - перевод
turn on
twins - близнецы
unfortunately - к несчастью
unlock - отомкнуть
urgently - срочно
went off (a gun = fired) - взорваться, выстрелить
whisper - шептать
with feeling - с чувством
worry - беспокоиться
worth - стоящий, заслуживающий

