Прим. куски помеченные словом "правила"
нужно смотреть отдельно в учебниках для pre-intermediate
или новичков

--мои
for God sake - боже милостивый
influence - влияние
balloon - шар
entertainment - развлечение, шоу
jabber - болтовня
injurious - вредный, ошибочный, оскорбительный
injure - вредить, оскорблять
tar - смола, деготь
jar - банка
jam - варенье, пробка
vice - порок
chip - тонкая пластина, место скола
mine - моё, рудник
mop - швабра
sight - зрение
sweater - свитер
spark - искра
own - собственный
screw - винт, вкручивать
sack - мешок, увольнять
sail - парус, плыть
fuse - плавить, запал
cutie - милашка
envelop - обертка
compound - строение, сложный, смешивать
matter - причина, материя
acquaintance - знакомство
charity - благотворительность
consequence - последствия
bare - голый
intermediate - промежуточный
out of - из
pond - пруд
reach - достать, дотягивание
even - даже (ещё), ровный
chore - рутина
though - хотя, даже, однако
admire - любоваться
confidence - доверие
confident - уверенно
garlic - чеснок
embarrassment - смущение
avoid - избегать
plane - самолет
announcement - объявление (анонс, реклама)
expensive - дорогой по цене
quite - вполне
crape - вуаль, повязка
skyscraper - небоскреб
luxurious - роскошный
exciting - возбуждающий
petrol - топливо
rather - лучше, точнее, наоборот
rare - редкий
razor - бритва
liberal = generous
fame - популярность
helicopter - вертолет
tour - тур путешествия
descriptive - описательный
adjective - прилагательное
there - там, туда
spectacular - впечатляющий
whose - чьё, чьи. чья
stump - обрубок, пенёк
earn - зарабатывать
butter - то что намазывают, масло
yoghurt - йогурт
grape - виноградина
spoil - портить, трофеи
possess - владеть
jewellery - драгоценности
thought - решил
throughout - во время всего, по всему
identifying - совпадать
theft - воровство
thaw - оттепель
thus - таким образом
that - тот
those - мн. that
these - мн. this
respect - уважение, иметь отношение, в это отношении
regard - отношение, забота, внимание
	regardless - неотносящийся, невнимательный
	regarding - относительно!
obvious - очевидно
certain - точно
admit - допускать, впускать
cord - веревка
Therefore - поэтому
Therefor - для этого
revise - проверять, исправлять
define - определять
enhance - повышать, улучшать
council - совет, совещание (консилиум)
appearance - внешний вид, появление
Pied - пёстрый
approach - приближаться
vanish - исчезать
cause - причина, дело, процесс суда
shore - берег
as well as - также как
each other - друг друга
political agenda - политические планы (хотя ед. число)
Cuisine by nationality - национальная кухня
how much is it - сколько это стоит?
terrified - ужас
slob - грязь
thumb - большой палец
thumb through - листать
suspicion - подозрение
appreciate - оценивать
align - выровнятьв линию, присоедениться
hierarchy - иерархия
either (айзее) - любой из (из двух), так(ой) же, тоже
whether - ... ли (напр. был ли, whether he was or not)
git - мерзавец
maven - эксперт
offspring - потомок, результат/продукт
offset - возмещать/возмещение
	offset - отход от чего-то (ответвление, отступ)
	offset - потомок
offend - обижать
fluffy - пушистый
involve - запутывать, вовлекать
awesome - потрясающий, благоговейный (ужасающий)
consider - полагать, обдумывать
	considering - учитывая
aware - знающий
cruel - жестокий
beg - просить, умолять
against - против (напротив, рядом, к)
leap - прыжок
mist - туман
inspire - внушать (принуждать, вдохновлять)
ray - луч
torture - пытка (то[р]ча)
torture - искажать, извращать
torch - фонарь, факел
hover - нависать (над чем-то, парить)
tie - связывать
tip - кончик, верхушка, наклоняться
tip - совет, инфа
obtain - получать
capacity - вместимость
assume - принимать
	let us assume that ... — допустим, что ...
proposal - предложение, план
explicit - ясно, искренне
Conclusion - вывод, следствие
jealousy - ревность, зависть
chart - схема, диаграма, чертеж, график и т.д.
attempt - попытка
epoch - эпоха (ипок)
retract - втягивать
enlightenment - просвящение (образование, обучение)
occur - случай
occur - случаться
token - знак, признак
due - должный, должное, налог
	due - прямо (due north - прямо на север)
grip - схватить, сжать
	gripe - схватить, сжать; недовольство, раздражать, ворчать 
terminal - конечный, граничный
assert - утверждение, отстаивать
indent
cipher - шифр, цифра
dash - мчаться, рывок
conjunction - связывание, соединение
scale - чешуя, осадок, чистить от осадка, весы, взвешивать, взбираться
		масштаб, градация, размер
Crest - гребешок, холка
swell - важный, важничать, стильный
		- выпуклость, шишка
inquisition - следствие, инквизиция
inhabitant - житель
acquire - приобретать
bin - мусорное ведро, ларец/сундук
ambiguity - неясность (двусмысленный, сомнительный)
  ambiguous - неясный (двусмысленность, сомнительность)
Redundant - излишний, многословный
dedicated - преданный, предназначенный (о оборудовании)
	dedicate - посвящать себя чему-то
halt - остановка, останавливаться
		ошибаться, запинаться, путаться
temptation - искушение, приманка

evolve - развивать, развёртывать, эвлюционировать
endure - выдержать, вынести, терпеть, длиться
  endurance - выносливость
perception - восприятие
vault - свод, подвал (хранилище), склеп (vault of heaven небосвод)
heaven - небо, рай
haven - гавань (пристань?), убежище, приют, пристанище
violate - нарушать

disgusting - отвратительный (часто о еде)
repulsive - омерзительный, отталкивающий
repugnant - отвратительный (часто о еде), противоречащий
straggle - беспорядок
  straggler - отставший, выбившийся из общего состава
curd - творог
chamber - комната, помещать в комнату
retention - удерживание
rubbish - мусор, хлам, чепуха
assignment - назначение (на должность, командировку), задание
awkward - неловкий
spot - пятно
sin - грех
enclose - окружать, огораживать, вкладывать
	(enclosed in the envelope - вкладывать в конверт)
sunburst - неожиданные солнечные лучи,
	украшение в виде солнечных лучей
volatile - летающий, меняющийся (для переменных в программировании)
fiend - демон, злой
allege - утверждать
assault - атаковать
convenience - удобство
	inconvenience - неудобство
dish - грязная посуда, подавать еду, кушанье (еда)
		- что-то нужное (происходит от хорошей еды?)
		My output was not everybody's dish. — То, что у меня в итоге получилось, могло понравиться далеко не всем.
stuck - застрять
would like - хотел бы
	I would like ...
graduate - выпускник
banish - высылать, изгонять, прогонять
circumstance - обстоятельства
slippy - стройный, изящный, шустрый

auxiliary - помощник, вспомогательный
participate - участвовать
	participle - причастие (часть речи)
subject - подлежащее
contracted form - сокращенная форма (I're not ...)
	
heist - грабеж, кража

indulge - потакать, позволять себе
	Only rarely will she indulge in a glass of wine. — Только изредка она позволит себе стаканчик вина
	indulging children - балование детей
debauch - гулянка, дебош, распущенность, соблазнять, разлагать (нравы)

endorsement - одобрение, согласие
abandon - покидать, несдержанность

conceit - самомнение, заносчивость
self-important - самомнение
grace - грация, достоинства, милосердие
	- украшать, награждать
	to say grace — возносить, приносить молитвы
preserve - сохранять, хранить, варенье

Premise (премис) - исходное состояние, сюжет (предпосылка, вводная)
Premise (примаиз) - предпосылать, основывать
sluggish - вялый, пассивный
derivative - производный, вторичный, не оригинальный
occasionally - иногда (от случая к случаю)
	occasion - случай

lounge - гостинная
dummy - манекен, модель в общем смысле

Groovy - превосходный
Grail - Грааль, чаша
diligent - прилежный
negotiate - вести переговоры, преодолевать препятствия, торговать
sweep - мести, смахивать, чистить
agile - проворный
skew - косая, уклон, ассиметрия
	skew - уклоняться (от пули)
	
Can == Tin - консервная банка

splint - мед. шина
rubber - резина, прорезинивать, резиновый
Deception - обман, жульничество

Overcast - сплошная облачность; мрачный, хмурый
drizzle - морось
malicious - злой, злоумышленный
otherwise - другой; по другому (говоря по другому ...)
Pagination - нумерация страниц

intend - намереваться
enter the University - поступить в универ

semicolon - ;
comma - , 

apparent - видимый, очевидный
retain - удерживать
solace - утешение, утешать; смягчение страданий
	Quantum of Solace - квант милосердия
truncate - усекать, обрезать

velocity - скорость
mandatory (adj) - обязательный
	mandatary (noun)
insult - оскорблять, оскорбление
	insulting - оскорбительно
polish - польский, глянец, полировка	

frock - платье
shorts - шорты
sweetheart - возлюбленный(ая)
stir - шевелить/взмешивать
intent - намерение; полный решимости (намеренный)
solitary - одинокий
confine - граница
entrance - вход
fascinate - восхищать
	fascinating - обворожительный
preposition - предлог, предложение
preposition - часть речи to, in, on и т.д.

reckless - необдуманный
	reck of - беспокоиться о
besides - кроме того
suspense - неизвестность
Aid - помогать, помощь
concern - проблема, вопрос который надо решить
application == request - просьба

Название игр:
pillar of Eternity
	pillar - опора, столп, основа
	Eternity - вечность, бессмертие (и бессмертие после жизни)
sage - мудрец
reduce - ослаблять
redux - возвращающийся (Kerry redux? — Керри возвращается?)
solitude - одиночество
chill - охлаждать, холодный/озябший, простуда/озноб
rogue - жулик
pray - молить (бога, о подаянии)
prey - добыча
	preying on - паразитировать на
doom - рок, судьба, гибель
quake - дрожание, дрожать
kindred - кровный родственник, родственный (схожий)
	kinsman/kinswoman - родственник/родственница
	kin - родственники
shatter - осколок, кусочек
shatter - разбивать
swarm - рой, стая, кишеть (масса кого-то?)
assault - атаковать
stellar - звездный
wax - воск
compendium - сборник

Seduction - Соблазнение
Intimidation - Запугивание 
Persuasion - Убеждение 
Domination - Доминирование 
Dementation - Помешательство 

swamp - болото
Lecher - распутник
entire - целый, полный
stock - запас
constraint - принуждение

engage - привлекать, вовлекать
	engagement - встреча

Oath - клятва
	Oathbreaker - клятвопреступник
skip - прыгать, прыжок
drown - тонуть

precisely - определенно, точно
credential - что-то дающее право заниматься чем-то, резюме, достоинство, качества, опыт

right away - прямо сейчас
loom - очертание, виднеется вдали
looming - ???
resides - находиться
grain == pip - зерно
Anthem - гимн
comprehensive - всесторонний
Lash - плеть, удар плетью
Severity - строгость
commute - переключаться (между чем-то)
lump - что-то большое (большой)

--фразы вежливости
Good luck
What about you
See you later
No, of course not
Same to you - тебе того же
Good idea
Well, I’m sure we’ll see each other again. -- well - хорошо (при прощании)
Safe journey
You're welcome - всегда пожалуйста
Pardon - извинение, за то что не услышал
I'm sorry - мне жаль (когда что-то уже случилось)
Excuse me - извините меня (пред извинение)
That's right - так точно (это правда)
Thank you for having me - спасибо что принимали меня (как гостя)
Pleased to meet you


--фразовые глаголы
pick somthing up - подобрать
look for something - искать что-то
turn something off
lie down - прилечь
turn round
try something on - примерить
throw something away - выбрасить

look after someone - присматривать
my car's broke down - сломалась
get on with somebody - ладить
run out of milk - закончилось
look up a word - искать в словаре
Look out! - осторожно

cross out - зачеркивать

put off - откладывать
put on - одеть

go on == continue

--тетрадь
###1
agony aunt - ведущая ток-шоу, советует как себя вести
casual - случайный, неокаратный, неофициальный
blind date - свидание вслепую
brave - отважный, отличный
chewing gum - жевательная резинка
cheers! - поздравляю
designer - разработчик, дизайнер
essay - испытание, эссе
downtown - деловая часть города
foreign - иностранец
clubbing - посещение клубов
mouse mat - коврик для мыши
outgoing - отбывающий, общительный
scissors - ножницы
pencil sharpener - точилка для карандашей
star sign - знак зодиака
surfing - сёрфинг
theatre - театр


rip-off - обдираловка
put in 5 cents - вставить 5 копеек
duty - обязанности
sit around - расхаживать без дела
cooker hood - вытяжка
oven - духовка
cupboard - шкаф для посуды
carpet - ковер (маленький)
rug - напольный ковер, парик
rag - тряпка, ругать, донимать
mat - ковер (возле двери)
wardrobe - шкаф, гардероб
fireplace - камин
curtain - занавеска
it's up to you - воля ваша
shelf - полка
drawer - выдвижной ящик, чертежник, составитель документов
chest of drawers - комод
chest - ящик, сундук, грудная клетка
sink - умывальник в хижине, выгребная яма; тонуть
basin - водоём, миска
yawn - зевать
giggle - хихикать
suburb - пригород
block of flats - многоэтажка
residential area(district) - спальный район
acquaintance - знакомство
housewarming - новоселье
fence - забор
sit on a fence - сохранять нейтралитет
appeal to - аппелировать, привлекать, призывать
pace of life - скорость жизни
not compulsory - не обязательно
compulsory - принудительно
ceiling - потолок
attic = loft - чердак
irritate - раздражать
yummy - вкусный
mean = greedy = tight-fisted - жадный
confused puzzled - запутаться
fall a sleep - засыпать
hairdresser's - парикмахер
hairdryer - фен
dry - сухой
wig - парик

Правила: have got - только в Present Simple и только о своём имуществе (в т.ч. органах)
	ответ: Yes, I have.

tanned - загорелый
suntan - загар
lead - свинец, вести за собой
neck - шея
mention - упоминание
manly - мужественность
compete - соревноваться
pleasant - приятно
thin - тощий
handsome - красивый (мужчина)
overweight - излишек веса
plump - пухлый
slim - стройный
hazel - орех (и лесной), ореховый цвет (как карий)
bald - лысый (читается как боулд)

окончание -ish означает "-ват" (высоковат, baldish - лысоват)

dye - красить (волосы)
belt - пояс
trousers == pants - брюки
tracksuit - спортивный костюм
earring - сирёжка
mature - взрослый
adult - взрослый
sophisticated - мудрая, утонченная
freckle - веснушка
birthmark - родинка
wrinkle - морщина
courage - отвага
liquid - жидкость
prefer - предпочитать

What + be + object + like? - Какой он? - спрашивают мнение.
What is he like? - какой он из себя?
What is Paris like?

look:	at - смотреть на
		after - присматривать
		for - искать
		out - осторожно!
		forward to - ожидать
		up to - равняться на кого-то
		up - искать в словаре

make up - мириться
have a row = fall out - ссориться
fallout - радиоактивные осадки, последствия(плохие)
role model - пример для подражания

niece - племянница
nephew - племянник

правило Tag Questions (5-ый тип вопросов, Disjunctive Question)
	You _are_looking_ after _your_ niece today, _aren't_you_?
	His wife _works_ in an office, _doesn't_she_?
	I _passed_ an exam, _didn't_I_?
	You _don't_ understand it, _do_you_?
Исключение: am not заменяется на are not (не касается am БЕЗ not)
	I am a boy, aren't I?
	
grumpy - угрюмая

Why don't we ... ? - почему бы

everyone считается ед. числом, добавляется is (как в He)

правила: Past Simple(что сделал), Past Continuous(что делал)
правила: произношение -ed

tell me, но say to me

clap hands - хлопать в ладоши
applauded - аплодировать

bold - жирный шрифт, отважный, наглый
injuries - повреждения, травмы
cuts - порезы
bruise - синяк
edge - край, лезвие

furious - неистовый от злости
give a lift - подборить (на машине)
puzzled - сбитый с толку
supper - ужин

rob - грабить
robber - грабитель
burglar - грабитель (взломщик)
thief - steal - общее название всем разновидностям вороства/грабежа и т.д.
to set afire - поджигать
arsonist - поджигатель
kidnapper - похититель
demand money - требовать деньги
carjacker - угонщик
jake - угнать
hijacker - угонщик самолетов
sentence to - приговорить к

skiresort - лыжный курорт
politely - вежливо
glue - клей
clay - глина
stair - лестница со ступеньками
ladder - лестница которую приставляют
firefighters = fireman - пожарные

правило: Adverbs (наречие)
	образуются: Adjective + -ly == adverb
	quick + -ly == quickly (говорить как? - быстро)

	с окончанием -y: angry + -ly == angrily
	
	исключения(основные):
		слова, которые не меняются:
			early
			late
			hard
			difficult
		меняются по другому:
			good => were
			
hardly - едва ли

правило: чтение дат, лет, числа
1907 - эйти оу севен
the thirty-first of August - August the thirty-first
2010 - two thousand and ten или twenty ten

правила: at, in, on и их исключения

fluently - бегло
near - близко
patient - терпение
vocabulary - лексикон
blur - пятно, размытость
purse - кошелек, дамская сумка
pleasure - удовольствие, (желание, воля)
plate - тарелка, табличка
pile - куча

правило: count/uncount, (a) little/few, a lots of, planty, many/much

правило: -ing -	образует существительные от глаголов
					absorbing — всасывание; поглощение
				образует прилагательные из глаголов
					interesting — интересный
				образует причастие от глаголов
					reading — читающий
					
know-all - всезнайка
petrol - бензин
teapot - заварочный чайник
bargaining - торговаться
homeboy - корешь
order - заказать
ham - ветчина
herbs - трава
cheap - дешево
cloth = fabric = texture - ткань
roast - жарить, зажарить
pavement - тратуар
lace - кружева
towel - полотенце
craft - ремесло

little bit - немного, небольшой кусочек
bit - немного
little == bit

fascinating - обворожительный
coconut - кокос
shirt - рубашка
excitement - восторг
go window shoping - глядеть на ветрины

sugar cane - сахарный тростник
consume - употреблять, поглощать
beet - свекла
tut - цык, выражение недовольства-нетерпеливости
washing powder - стиральный порошек
powder - порошек
sweet tooth - сладкоежка
mountain range - горный массив
sigh - вздох
envelope - конверт, обертка

правило: a/an, the, исключения

---the					
unique
превосходная степень прилагательного
	(the best)
rivers, seas, oceans
group of lakes
mountain range
name of country
	(with the several words)
ordinal numbers(порядковые, the first chapter)
профессии
о чем-то конкретном
	(уже известном)

---a/an (древняя форма one, при первом упоминании)

---БЕЗ the
lake (одно)
mountain
country 1 word
direction + country (North America)
cordinal
	(числительные, chapter 3)
континенты


правило: составление заявок на прием на курсы (postcard)

правило: some, any, no

wounded pride - задеть гордость
catwalk - подиум
sleeve - рукав
collar - воротник
heel - каблуки, пятка, наклонять
dress - платье
suit - костюм
shush - замолчать, заставить замолчать
tuxedo - смокинг
tie - галстук, лента, шнурок
jacket - куртка
coat - пальто, одевать, пиджак
jumper - сарафан, толстовка
skirt - юбка
boots - ботинки
shoes - обувь
hat - шляпа

butcher's - мясная лавка
backer's - булочная
off-license - алкогольная лавка
fish-mongers - рыбная лавка
dry-cleaner's - химчистка
chemist's = pharmacy = drug store - аптека
dairy - молочная лавка, маслодельня
DIY store - сделай сам магазин
stall - ларек
Stationery - канцелярские товары

spiky hair - торчащие волосы (?)
foam - пена
sparking - энергичный? зажигательный?
earn - зарабатывать
borrow (from) - одалживать
lend to - одалживать кому-то
pay back - вернуть долг
currency - национальная валюта
bank note - бумажные деньги (в 1 или 2 слова)
coin - монета
spend on = waste on - пустая трата
have/earn/make money
can't afford - не могу позволить
invest - инвестировать
income = profit - доход
bet ... on ... (money) - ставка на
gambler - азартный игрок
tip - чаевые
demand - требовать
carry - поддерживать
tear - рвать
generous - щедрый
mean = tight-fisty = greed - жадность
owe - должен (он, кто-то), (he owe me)
account - счёт, учетная запись
jar - банка
a jar of jam - банка варенья
a pot of tea - кружка чая
recall - вспомнить
workshop - мастер класс

правило: инфинитив, герундии
Gerund (-ing)		Infinitive (to)		Infinitive (без to и -ing)

love				want				can
like				hope				could
enjoy				would like			must
prefer				would love			may
look forward to		be going			might
finish				forget
began		-		began
start		-		start
continue	-		continue
think of			decide
hate				been
					gone
					
правило:
	would - бы
	could - мог
	should - следует

been to ... - уехал и вернулся
gone to ... - уехал и остался		
					
bellman - зазывала
quite - вполне, совсем
ice-rink - ледяной коток
rink - каток
devote to - посвятить чему-то ...
employ - нанимать
insane - душевнобольной
headache - головная боль
it drives me mad - это доводит меня до бешенства
instant - мгновенный, миг, момент
snap - щелчок
swear - ругаться, клясть, клясться
thrillers - триллеры

правило: будущее время
	1. внезапные действия, спонтанные решения
		(snap decision, instant) - используется will
		I hope, he'll ...
		I'm sure...
		I think...
	2. Запланированные действия (наверное сделаю, собираюсь, вероятно будет)
		be(am/are/is) going to + ... (We’re going to get married in June)
			- собираюсь что-то сделать, очевидное действие в будущем
			going to go to == going to (опускается часть с повторным go to)
	3. Точные планы (запланированные, точно сделаю)
		используется Present Continuous - planed action
	4. Если разговор о расписании, план действий (timetables)
		используется Present Simple (The airplane takes off at 2.30 p.m.)
	will, отрицание - won't
	
vision - видение
predict - предсказать
prediction - предсказание

rebel - бунтовать
baggy - мешковатый
truant - прогулы
bullying - запугивать
bully - тот, кто запугивает
shoplifting - кража в магазине
desperate - отчаяние
get rid of (it) - избавиться, выбросить
play truant - прогуливать

strict - строгая
guide - проводник, вести, направлять
bleach - отбеливать
obsession - одержимость
pineapple - ананас
pine - соска
fluent - беглый
break you leg - ни пуха ни пера
screw driver - отвертка
screw up - накосячить
frightening - пугающий
impatient - нетерпелив
embarrassed - в неудобном положении
miserable - жалкий, непростительный
fine - штраф

правило: could/can/will, be able to ...
			be allowed to ...
			should
			
shabby - потрепанный
pace - скорость абстрактных вещей (которую нельзя посчитать)

flu - грипп

правило: What + be + объект + like? - Какое оно из себя?
										(твоё мнение)
	What's it like?
	
shabby - потрепанный
pace - скорость абстрактных вещей

правило: степени сравнения (общее)

Adjective		Comparative		Seperative
--одно слоговые (y == ie, funny - funniest)
	если V + согласная, то согласная удваевается
1)
thin			thinner			the thinnest
fast			faster			the fastest
nice			nicer			the nicest
--однослоговые, но по многослоговому правилу
clever
2)
--многослоговые
comfortable		more comfortable	the most comfortable
3)
--исключения
good		better				the best
bad			worse				the worst
many,much	more				the most
little		less				the least
old			older/elder(старее, старше)		the oldest/eldest
far			further/farther		the farthest

если adj (прилагательное) заканчивается на -ly:
	wisely		more wisely		the most wisely

further - когда о об абстрактном
farther - о расстоянии

4)
be(isn't) + as ... as ... - такой же как
so ... as ... - настолько же как

правило: like (like a dog)

5) this sofa is much(a lot) more comfortable

medieval world - средневековье
crowded - переполненный
fairly - достаточно
plumber - сантехник
van - фургон
detach - отдельный (напр. дом)
handsome - привлекательный
impolite/polite - невежлевый/вежлевый
boil - кипеть
wealthy - богатый
crawl - ползать
tight-fisted - жадный
sharpen - точить
tap - сантехнический кран, затычка

правило: Relative clauses - Butcher who slice meat.
	(that - этот который)
Употребление слов с объектами
	people		who/that
				
	things		which/that
				
	places		where
	
contemporary - временный
whose - который, чей

Синонимы:
Adj			Synonim(same)			Antonim (opposite)
bored		fed up					interested
wonderful	amazing					usual (routine)
modern		contemporary			ancient
impolite	rude					polite
untidy		dirty					tidy
generous	liberal(kind)			mean
cold		cool					hot
miserable	unhappy					happy


kangaroo - кенгуру

правило: Present Perfect
	указывают слова:
		recently/already/ever/never/just
	... hasn't ... yet.

Употребляются с временами Perfect:	
... for ... - в течении
... since ... - с какого-то времени

for three years - в течении 3 лет

если есть this/last/next/every - то нету предлогов (for/since и т.д.)

flop == fail
havoc == chaos
apparently - видимо, вероятно
upset - расстроен
fire = sack = dismiss - увольнять
spoilt - испорчена

правило: образование существительных

--noun			verb
arrival			arrive
trainer			train
invitation		invite
organization	organize
explanation		explain
decision		decide
employer		employ (наниматель - нанимать)
employment
employee
improvement		improve
discussion		discuss
agreement		agree
imagination		imagine
advertisement	advertise

--noun			adjective
mood			moody
friend			(un)friendly
fame			famous
patience		patient
happiness		happy
kindness		kind
difference		different
danger			dangerous
disaster		disastrous
beauty			beautiful
use				useless
				useful
help			helpful
				helpless
				
moody - с переменчивым настроением

easy going - добродушный
improve - улучшать
out of - из чего-то, 30% из 100
hint - подсказка, намёк
heaven - рай
for ages - вечность
for a while - некоторое время
tick - галочка, отметить галочкой
work long hours - работать много
get on - ладить
leisure - досуг
motivation

fill in for - заменять
Let me sleep on it. - дайте подумать до утра

о графиках:
in the black - прибыль
in the red - убыток

get/set the ball rolling - начать чем-то заниматься

CV - резюме (брит.)

правило: must/have to

bills - счета
knees - колени
nieces - племянницы
treat - лечить
so on - и т.д.
till - до
solve = figure out = sort out - решать
legal secretary - секретарь в суде

gain - зарабатывать, достигать

vacancy
high time - самое время
commuter - житель пригорода (постоянно ездящий в город)
perks = fringe benefits - доп. деньги (сверх дохода)
salary - зарплата
annual - ежегодный

whom - кого
keen - острый, тонкий, проницательный, стремящийся, отличный

fiancee - невеста
fiance - жених


правило: боль
1)
head		-ache
stomach
tooth
ear
back
ear
2) со всеми остальными слово pain
I have pain in my knee.

running/runny + nouse - насморк

sneezing - чихание

pretend to - притворяться
pressure - давление
sunburn - солнечный ожог
dizzy - головокружение

wasp - оса
bee - пчела
sting - жало
hiccup - икать
yawn - зевать
toe - палец на ноге
tiptoe - ходить на пальчиках
bucket - ведро
powder - порошек

itchy - зуд
I have itchy feet. - я люблю путешествовать.

it's cost me arm and a leg - это стоит мне состояния

cough - кашлять

правило: составление письма

frequently - часто
however - тем не менее
accommodation - жилье
laid-back - пофигист

sincerely - искренне ваш (Yours sincerely)
	(если в письме есть имя или фамилия)

faithfully - с уважением (Yours faithfully)
	(если в письме Diar, Sr, Madam, Miss)

правило: First Condition (real future)

pal = mate = friend
pen pal - друг по переписке
homeboy - корешь
chase - погоня
rain jacket = rain coat - дождевик
rub - тереть
insect repellent - средство от насикомых
call out - выкрикивать
checky - хитренький???
toss a coin - подбросить монету

######9

слова:
custom - таможня
	customs official - работник таможни
seasick - морская болезнь
speed boat - парус
yacht - яхта
impression - впечатления
catamaran = double canoe

fare - оплата за проезд
sliding doors - раздвижные двери
conductor
bus stop - остановка
tube = subway = metro
hail??? - остановка такси
hail - град, поток
single-decker - одноэтажный автобус
coach - международный автобус
rack - полка, вешалка
crew - экипаж
cab - такси
rush hour - час пик
at - на остановке/вокзале
get off - выходить из транспорта
honeymoon - медовый месяц

entertainment - развлечения
holiday resort - курорт
scenery = landscape
reckon = suggest = suppose - полагать

hurricane - ураган
overlook = face - выходить окнами на
quit - бросить
re-sigh - уходить в отставку
excess baggage - превышение багаж
in order to - для того чтобы
check in - регистрация
cockpit - кабина экипажа
aisle - проход
bumpy - не ровный, тряский
curious - любопытный
ski slopes - лыжный спуски (склоны)
	slope - склон
tender = gentle - нежный

fabulous - сказочный
insurance - страхование
owe - быть должным


правило: First Condition (real future)

(1 часть) If/before/after/when/until/as soon as + Present Simple,
(2 часть) + I won't/will + V
(можно менять местами)
	- если/до/... я сделаю что-то + то потом точно сделаю другое
		(и выполнить это реально)


Do-actions: exercise, jumping jacks
	activities: crossword, sudoku
	chores: homework, loundry
		do nails, do hair
Make:	construction:
		building:
		creating:	make a dress
					a cup of coffee


-- do
the cooking (готовить)
the washing up (стирка)
the ironing (утюжить)
a favour (одолжение)
a course (курс)
homework
well/badly
(smbd) best (делать от кого-то всё зависящее)
loundry (стирка)
nails
hair
next year

-- make
a sandwich
friends
a mess
a decision (принимать решение)
up my(your) mind (принимать решение)
a mistake
a fortune (сколачивать состояние)
a phone call
the bed (застилать кровать)
full (?)
a fool
a noise
a cup of coffee
make an excuse - извиняться
make sure - убедиться

-- get

get become - стать
get angry
get hungry
get wet

get arrive - прибывать
get home - придти домой
get to work

get a cold - простудиться
get obtain/get receive - доставать
get sunburnt

get marriend
get up - встать
get on (with smbd) - ладить
get off - выходить из транспорта
get out
get over = recover - преодолеть, восстановиться
get dressed
get ready - готовиться
get to the station
get lost

-- take
take a photo - делать фото
take a bath/a shower
take on == employ - нанимать
take care
take tablets


-- направления движения
along - вдоль, или "идти по" (дороге)
go across = across - пересекать (улицу)
over - по чем-то или через что-то, напр. "по мосту"
through - через (тоннель)
into - войти куда-то
off - спускаться с чего-то (с крыши)
out of - выйти из чего-то
past - проходить мимо
from ... to - с какого-то места ... в какое-то другое место
up - подыматься
at the top - на вершине
down - спускаться ( с горки)
at the bottom - внизу

In spite/despite of Ving. - не смотря на (что-то)
spite - на зло (кому-то)
despite - вопреки, злобно

___ + needs + Ving - что-то надо(needs) делать.

######10

слова:
ashtray - пепельница
window sill - подоконник
sellotape - скотч
rope - веревка
shoelace - шнурок
torch - фонарь
corkscrew - штопор
comb - расческа
razor - бритва
act a fool = fool around

purpose - цель
on purpose - специально
by chance - случайно

I'm on business - по делу
I'm in business - бизнесс мен

on time - во время
in time - точно во время

cure - лекарство
gripping - захватывающий

misprint - опечатка
leg work - работа принеси-подай
big cheese - большая шишка
cockroach - таракан
cock - петух
burst into tears - взорваться слезами
let of be - пуская так и будет
hang out with - зависать с кем-то

you snooze - you lose - дремать - проигрывать

rower - гребец
inspire - вдохновлять
role model - пример для подражания

He is 404 - он глупый
ride - горка

out-of-date = old-fashioned - устаревший

shrunk in the wash - потянулось в стирке

melt - таять
moan - ныть
nag - пилить (эмоционально)

have a row = fallout = have an argument - ссориться

fallout - радиоактивные осадки

lose temper - выходить из себя
make a dramas of little things - делать драму из мелочей
chores - домашние обязанности
distract - отвлекать
absent-minded - рассеянный
get on (sb) nerver - действовать на нервы
by for now - ну всё пока

правило: passive voice
	(на курсах только для времен:	
		Present Simple (is), Past Simple (was/were), Present Perfect(has been), will Future(will be))
	- действие над предметом (шар был отпущен)
by + person (с одушевленными) - ... сделан кем-то
with + thing (с неодушевленными) - ... сделан чем-то
образуется:
	to be (+ not) + V3 + (by/with + person/thing) - Paper was not stolen by cats.
	для will отрицание: will not be
	вопрос: Will ... + be + V3?
Greece is visited by me.
I am drunk.

both ... and ... - оба и ... , и ...

put you through - соединять по телелофону
say to me == tell
hold on - ждать
take message
leave message
rope - веревка
light bulb - лампочка

discover gold
tell a lie
lose weight - терять вес
give a lift - подвести
miss - потерять, скучать, промахнуться, пропустить
lose - утрачивать, проигрывать (уменьшать)
get lost - заблудись!
keep a secret
say hello
do homework
make a complaint
miss the bus

######11

правило: second condition

shout at - кричать на
		to - кому-то

throw at - бросить на кого-то
		to - кому-то

move to - переехать
find out - узнать
bark - лаять

It's not my cup of tea. - это не моё

can't stand you - не могу терпеть тебя

правило: such/so
			- перед прилагательным so,
			- перед существительным или прил. + сущ such
			such a good man
			so good
правило: might

deer - олень
pear - груша
waist - талия
weak - слабый
wrist - запястье
hire - нанимать
fair - рынок, красивый
fare - оплачивать проезд, достичь
court - судья
though - хотя

it depends - когда как

currently - сейчас


######12

слова:
so far - пока ещё
ceiling - потолок
bake - выпекать в духовке
confidence - уверенность
relative - родственники
come round - заскочить в гости

even - даже, плоский, ровный
goal - задача, цель, гол
lately - недавно
faith - вера
score - очки в игре
score a goal - забить гол
will last - будут длиться
filthy - запачканный

wear - носить, относится и к духам
drop a line - чиркнуть строчку
set off - отправиться
sled - сани
silly = stupid - глупый
look up to - равняться на кого-то
seal - тюлень
although - хотя, не смотря на
delighted = happy

правило: слова частоты действия ставятся перед глаголами

take up - начать заниматься
altitude - высота
congratulation on - поздравить с чем-то
candid = sincere - искренне
see off - провожать

Pardon - извинение, когда не расслышали

pity - жаль, жалость

hen - курица
hen party - девишник

bachelor - холостяк, бокалавр
stay party - мальчишник

line - очередь

catch a plane - полететь на самолете

правило: с Nobody в отрицании уже не нужно "not"

get a cold - простудиться
vinegar - уксус


правило: Present Perfect Continues
	действие началось в прошлом и ещё не закончилось,
		или закончилось сразу перед разговором
		или закончилост, но подчеркивается длительность действия
has/have + been + Ving
признаки времени:	слова recently, lately,
					часто в вопросе How long + have + (you) + been + Ving?
					часто слова: ... + for, during, since

Слова, которые не употребляются с временами Continue (мысли, чувства, модальные глаголы):
	understand
	know
	realise/realize (реализовывать)
	think
	suppose
	
	have
	want
	need
	seem
	
	smell
	love
	hear
	like
	prefer
	hate

go/come, bring/take
go - быстрое движение с места говорящего куда-то
come - разговор о движении к месту где находится говорящий
bring - нести что-то/кого-то (кому-то) в другое место
take - нести что-то/кого-то с одного места в другое

--разговорный курс
rely - положиться (на кого-то ...)
nursery school - ясли
by into smth? == be interested - интересоваться чем-то
ask smbd to do smth - попросите кого-что-то делать
pregnant - беременная
downtown - центр города, деловая часть города
peace of advice - один совет (т.к. advice - мн. число)

pick == choose
like ... very much
to - (часто переводится) чтобы
keep in touch - быть на связи
keep in touch == stay in touch
seek - искать
quarrel - ссориться
switch movies after - что-то меняется
got game - доигрался
Horoscope - гороскоп

capable - способный
accomplish - выполнять до конца, совершенствовать
closure - завершение, закрытие
move on - продолжать двигаться
surge - волны
ahead - будущий, впереди
grand - большой
excessive - черезмерный, излишний
attitude - позиция, отношение
glimpse - мельком
elaborate - тщательно
visionary - мечтатель, провидец
irrespective - бессознательный
remain - оставаться
frustration - разочарование

Знаки зодиака:
Aries - Овен (ариес)
Taurus - телец (торас)
Gemini - близнецы (джеминай)
Cancer - рак (кансаа)
Leo - лев (лио)
Virgo - дева (вёрго)
Libra - весы (либра)
Scorpio - скорпион (скорпиоу)
Sagittarius - стрелец (саджитериос)
Capricorn - козерог (каприкоон)
Aquarius - водолей (эквэриэс)
Pisces - рыбы (пайсис)

Прилагательные:
reasonable (рациональный) == sensible - здравомыслящий, здравый, рациональный
sensual - чувственный
willed - волевой
outgoing == sociable - общительный
inquisitive - любопытный
good at details - педантичный
playful - игривый
efficient - эффективный, результативный
stubborn == obstinate - упрямый
reserved - сдержанный, замкнутый
bossy - любящий покомандовать
flirtatious - любящий по флиртовать
affection - привязанность, любовь (родственная?)
loyal - преданный
deep - глубокомысленный
caring - внимательный, заботливый
careful - заботливый
ambitious - амбициозный, целеустремленный (считается очень положительным качеством)
combativity - боевой
argumentative - любящий спорить
modest - скромный, ограниченный
	modest circumstances - стесненные обстоятельства

one/ones - слова заместители в предложениях. Могут иметь ввиду существительное понятное из контекста.
	They are selling their house to move to a smaller __one__. — Они продают свой дом и переезжают в другой, поменьше.
whose turn - чья очередь?
... slipping by - подскользнуться
slip - скользить
	slipping - скольжение
come up with (an idea/products) - придумать (произвести)
date - свидание
date - устаревать
	... will never date - никогда не выйдет из моды
blind date - свидание в слепую
cycle - ездить на велосипеде, велосипедный
	cycle == ride a bicycle - кататься на велосипеде
rough - бурный, грубый, дикий

come you from - откуда вы?


bet - могу поспорить (могу поставить на это)
significance - значение
Christianity - христианство
Christians - христиане
coincide - соответствовать, совпадать
pagan festival - языческое празднование
Dutch - голландский
legislators - законодатели
Mardi gras - жирный вторник, как масленица
treat - относиться
	He treats me like dirt.
convicted - уличенный, осужденный
put up - вешать
carol - рождественская песня
raise - поднимать
wreath - венок
mistletoe - омела белая
cane - трость
tinsel - мишура
mince - фаршированный
reveal(s) - обнаружить, разоблачать (напр. секрет)
chimney - дымоход
reindeer - северный олень


shuffle - засовывать, тасовать
	reshuffle - перетасовать
as well - так же

keep on == carry on == go on
break down - сломать
bring up - выставлять/вызывать на публику (вытаскивать на свет)
playing up - делать не серьезно, дурачиться вместо работы
erratically - хаотично
(it) throw out - выбросить
turn out??? == end result - в результате
agree == go along with - согласиться с кем-то
call someone in to - позвать
break down - если про окно, то будет иметься ввиду механизм окна, а не стекло?


push it - задвигать до предела (Don't push it - хватить грузить меня?)

raw == crude - сыро (о еде, даже прожаренное с кровью)
middle - средней прожарки
well-done - хорошо прожарено

I have finished. == I am already. - я готов
heat - жар
	heater - батарея (например)
heat on - включить отопление
amendment - изменение в законах (корректировка), чем-то официальном
interested in, но fascinating by - интересоваться чем-то

pick up (== go and get)
give (me) a lift - подбросить
drop (me) off - высадить кого-то (из машины например)
set off == leave (for) - отправляться (He set off for work an hour ago.)
	set off + time
	set off + for + place
hurry up - поторопиться
hold up (== stuck) - застрять (... get hold up ...) - застрять

on road (в дороге):
	speed up a bit (== go a bit faster) - немного прибавить скорости
	slow down (== go slower) - медленнее
	cracking down on [me] (== getting strict)- быть строгим с (кем-то)
	fill up - заправиться (как buy petrol)


eagerly - пылко, страстно
glance - мельком (взглянуть мельком)
firmly - надежно, твердо
ought - долг (моральный)
moustache - усы (мэсташ)

slightly - слегка
	отдельно от прилагательного не употребляется
		slightly surprised - слегка удивлен

reply - ответ, отклик
choker - то, что душит
anxious - тревожный
funeral - похороны
violet - фиалка
fair - красивая, белакурая
nasty - противная
hesitate - колебаться, сомневаться
obedient - послушный
	obedience - подчинение
fuse - плавкий предохранитель
deliberately - преднамеренно
whistle - свистеть
lean - наклоняться, худой

concession - уступка
fond - нежный

manufacture == made
convince - убеждать

мнение (how you give opinion):
1. strongly opinion
	I am convinced that ...
	It's really clear that ...
	It's obvious that ...
2. neutral
	I think that ...
	I believe that ...
3. weak
	It's seems to me that ...
	I would say that ...
4. expressing concession
	Although ...	- Although nuclear energy is clear, I wonder if it really safe.
	In spite of the fact that ... - In spite of the fact that it's dangerous, a lot of young people still smoke.

substitute == change - заместитель, замена
subhuman - не человек, животное
warranty - основание, гарантия
schedule - график, план, список
fit - подходящий по размеру

I can swim == I know how to swim

be up to (smth) == делать что-то
go over == review - обычно о известном предмете (Я иду посмотреть?)
worked (smbd[them]) out == calculate - посчитать числа
set up - назначить встречу, привести в порядок, установить что-то
	set him up - поставить его на ноги
take (smdb) through (sth) == explain (smth) to (someone) - объяснить что-то кому-то
	I'll take you through it one more ​time, then you can ​try it yourself.
	take through - сделать до конца
tied up - сильно занятой
fit (me) in (today) - уделить время (мне)
By the way - кстати
be dealth with (smth) - поработать над чем-то
	I dealth with deals.
see to -  смотреть, наблюдать (о планах)
	Вроде как: "Я посмотрю что с этим делать"?
enquire (== inquire) - искать, спрашивать, узнавать

vehicle - транспортное средство
persuade - убеждать
mould - плесень
nevertheless - тем не менее, всё-таки
establish - учреждать, устанавливать
	establish contact

humanity == mankind
renewable - возобновляемый
adopted - принятый, приемный
	adopted child — приёмный ребёнок
	adopted legislation — принятое законодательство
former - создатель, разработчик, шаблон
	
former - бывший, прошлый, давний
	former passage — предыдущий абзац
	Of the two spellings, the former is more common. — Из двух вариантов написания первый является более распространённым

jogging - бег
sweets - сладости
carbohydrates - углеводы
supplement - добавка (напр. пищевая)

tag question для may - это can?

helmet - шлем
golfer - игрок в гольф
caddy - носильщик клюшек в гольфе, чайница (банка для чая)
tennis player - тенисист
goggles == glasses - очки
goggles - очки с круглыми линзами
goggle - вытаращенные глаза, изумление
racquet (== racket) - тенисная ракетка
	racket - сильный шум, шумиха вокруг чего-то
	run a racket — шантажировать
controversy - спор

trunk - спортивные трусы, плавки
	swimming trunk - плавки
trunk - чемодан
trunk - ствол (дерева)
trunk - туловище, тело, корпус
trunk - система селекторной связи
trunk - магистраль
trunk - вентиляционная шахта
trunk - хобот
trunk - багажник
trunk - это нечто вытянутое вроде трубы (труба, мгистраль), какое-то тело (живое или неживое), багажник, спортивные трусы (напр. плавки), чемодан

off the cuff - без подготовки

fin - плавник
side-car (sidecar) - коляска мотоцикла, мотоцикл с сидением
trampoline - трамплин, батут
puck - шайба

court - маленькое поле, теннисная площадка
court - навлекать что-то плохое своим поведением
	to court disaster — накликать беду
court - ухаживать
court - привлекать, переманивать
court - тупик

strip - лента, узкая полоска
strip - обнажать (обнажать овощи == чистить и т.д.)

stove - печка, кухонная плита

--opinion
Asking for an opinion.
	1. Do you agree that ...
	2. Do you think that
	3. How do you feel about it? - что вы думаете об этом?
Agreeing with opinion
	1. You're quite right about ...
	2. Of course ...
Disagreeing with opinion
	1. I'm sorry, but ...
	2. I really can't agree. ...
	3. You may have a point, but ...
	

sum up - подводить итог

--Порядок применения в тексте слов:
1. first of all
2. secondly
3. also
4. to sum up
5. finally

assignment - задание; командировка как задание
ambiguously - неясно, неопределенно
(отчётливо) distinctly == (понятно) clear == (о погоде) it is fine - ясно

abide - следовать чему-то, выносить (жизнь)
	abide by a peaceful policy

prohibition - запрет (запрет чего-то, любой запрет)
fairly - красиво, мило, должным образом, объективно
			The story was told fairly and objectively. — История была рассказана честно и объективно.
			The table was set fairly. — Стол был чудесно сервирован.
	- чётко, ясно
			I have fairly seen him. — Я отчётливо его разглядела.
	- довольно; в некоторой степени
			fairly easy problem — довольно простая задачка
			
infliction - причинение (страдания); наказание

basset, hounds - породы псов
habitat - среда обитания
inflict - наносить повреждения
endangered - вымирающий (под угрозой)
depleted - истощенный
species - виды (животных)
cruelty - жестокость
whip (хвыып) - хлыст
catch - улов (напр. рыбы)

loan - заем, давать в заем, одалживать
matter - вещество, материал, вопрос/причина/основание
matter - иметь значение
	mattering wound — гноящаяся рана
as a matter a fact

mortgage - ипотека, заклад, закладывать, заем

porpoise - морская свинья
spills - утечка, разлитие, разливать
contaminated - загрязненный

emphasis -  выразительность, сила, ударение; эмфаза
	emphaizing - подчеркивающий
	emphaize - подчеркивать
till - касса
garment - предмет одежды (напр. рукав); одеяние
	garment - одевать
reliable - надежный
refund - компенсация, компенсировать
shop chain - сеть магазинов
promotional - рекламный
	promotion - продвижение (по службе), рекламная компания
department store - универсальный магазин
tyre == tire - автомобильная шина, покрышка

stroke - гладить (ласкать)
put back - откладывать (в т.ч. рейс)
touch down - преземлиться
flock - толпа
strike == hit
flagship - флагман
cramped - тесный
face to face - иметь дело с чем-то...
strike - забастовка

take off == I'm off - жаргонное "я ушел"

journey меньше по времени чем travel

fortress - крепость
whitewashed - побелены
jewels - драгоценности
palace - дворец

nearly - почти, около;
	- близко/приблизительно
near - возле/около
nearby - поблизости

scrap - лом (металолом), кусочек
occupying forces - окупационные силы
deliberately - сознательно/умышленно
artillery - атиллерия
eyeball - глазное яблоко
burned out - сгорел (вы-жечь?)
poker - кочерга, покер
councillors - советники

wharf - верфь
imposing - производящий впечатление (импозантный)
formidable - могущественный (впечатляющий, грозный)
dilapidated - полуразрушенный
	dilapidate - разваливать/разрушать
rather - довольно (в некоторой степени)
	это другой смысл слова
penitentiary - исправительный (лагерь)

locked up - замкнут (замок)
notorious - известный; печально известный, известный чем-то плохим
inmate - обитатель; заключенный
surely - конечно
maritime - морской
lighthouse - мояк
ferry - паром, переправа; перевозить
sanctuary - святилище/храм/заповедник

ДЛЯ ПРАКТИКИ МОЖНО ПОЧИТАТЬ ЖУРНАЛ The Times (не газета!) там используется 5000 популярных слов

abbreviation - аббревиатура
point out - указывать
site - местоположение
shot - снять видео/фото
stage - помост, платформа
set == setting - место действия
	set - съемочная площадка?
set - музыкальный номер
on location <in California> - в месте ...
gig (слэнг) - концерт, не классический (pop, rock)
score - фоновая музыка
rehearsal - (типа перепрослушивание) репетиция, повторение
sill life - запечатлен (о картинах и фото)
cast - актеры + актрисы (в спектакле/фильме)

wind - наматывать
	rewind - перемотка
wind down - сводить на нет, исчезать (жаргонное расслабляться)
departure - отъезд, отправление
	The morning of our departure we...
warden - смотритель/хранитель

--refuse/accept offers
Making offers:
	Why don't I ... ? - Why don't I do smth?
	I could ...
	If you (do), I will ...
Refusing offers:
	I'm sorry, but I'd rather ...
	No thanks, I really prefer ...
Accepting offers:
	I'd be pleased to ...
	Fine, I agree to ...

	
indirect form - в прямой форме
--ask polite questions
Polite indirect questions:
	I'd like to know ...
	Could you tell me ...?
	May I ask ... ?
	Do you happen to know ... ?
Interrupting politely:
	Excuse me, but ...
	May I ask a question?
	Could I (please) ask ... ?
	
--ask questions
Open question:
	How ... ?
	Why ... ? - why do you like smth?
	For what reason ... ? - For what reason do you do smth.
Asking for explanations:
	What exactly do you mean by ... ? - What exactly do you mean by "abstract mind" ?
	Could you explain a bit further ... ?
	Would you like to add to your comments about ... ?

tram - трамвай
amuse - забавлять, развлекать
	amusing - забавный

First of all = firstly
Second of all = secondly

порядок слов в тексте:
	First of all
	Secondly
	Next
	Then
	In additional
	Finally

depends on - зависит от ...
working on - работать над ...

apostrophes
Jake's - принадлежащий Джейку
girls' - девушек (принадлежит девушкам) - если на конце -s
'89 - 89-ые
distinguish - различать, отличать
	distinguished - отличный (хороший или различный)
distinguish = gentleman???

strong coffee - крепкий кофе
collocation - расположение
implication - следствие/вывод, вставка/включение/вовлечение
on my own === myself - сам
blustery - бушующий, бурный (поток), буйный

colon - ":"
semicolon - ";"
comma - ","
dash - "-" тире
dot - "."

clause - статья
claim - требование, требовать
	
clause - вроде как ещё и такая "вставка в предложение"
	That Tuesday, which happens to be my birthday, is th only day when I am available to meet.
	I don't trust that products that claim to contain all natural ingredients because that can mean almost anything.

отличия that/which во вставках в предложение:
	that - для важной инфы
	which - для дополнительной, не важной

	
conjunction - связывание, сцепление

data - произносится как "дата"

mall - аллея, торговая аллея, торговый ряд
heavy - тяжелый
substance - субстанция, вещество, содержание
proper - присущий, правильный, должный
 от property
plural - множественный

maternity - материнство
maternity leave - декрет
vocation - призвание, профессия
gossip - сплетни, сплетник
tabloid - формат газеты (малоформатная газета)
impartial - непредвзятый
slot - щель, выемка, паз
slot - употребляется для обозначения промежутка (напр. промежуток времени)


leak a story
break a story - рассказать эксклюзивную историю
make the headlines - написать заголовки газет
run the news - запустить новости
give an interview

facility - возможность, отсутствие трудностей, льготы

clutter - помехи, суета, шум (мельтешение??)
fuss - суета, шумиха, протест
clutter == fuss

regular columnist - обычный журналист писатель колонок
accused of - обвиняемый в
rumour == rumor - сплетня, слух
be about to separate - почти развелись
	about - приблизительно
about - повсюду, какое-то место
	is about the garden

будущее:
	going to (plans)
	will (prediction)

might == could == possibly - неуверенность
Maybe He does not come.
He might tell us about his girl.

meanwhile - пока, тем временем (в течении времени)

---------Курс intermediate

handout - распечатка (и рекламка); подояние
orally - устно

been in (Russia) - был в стране, и во время разговора в ней (напр. приехал второй раз?)
been to (USA) - был в стране и вернулся

What are you? - какая твоя профессия?
How do you do? - как ты?
How is it going? - как дела?

constantly - постоянно
leave for (Gomel) - уходить по направлению к (Гомелю)
prefer smth1 to smth2 - предпочитать что-то1 чему-то2
achieve - достигать
	achievement
inland - внутренняя часть страны

fried - жареный (кортошка фри?)
bride == marriageable (girl) == fiancée - невеста
agriculture - сельское хозяйство
chairman - главный где-то, председатель
whoever - любой
memorize - запоминать
expense - расход
	expend == spend - тратить

(to be) off - понижать (как спускаться)
I'm off. - я ушел
to be out with - быть в ссоре
day off - нерабочий день
Mind your own business. - это не твоё дело

come true - сбыться
lack - нехватка
husband - муж
seldom == rarely - редко

How long does it take? - как много времени это отнимает?
write (it) down - записать (это)
get to (Minsk) - добраться до (Минска)
	вместо get можно использовать любой глагол движения
Let's get together - давайте соберемся вместе
Cheve (от Chevrolet) - шевроле
Chevy - погоня, гнаться, охота, охотиться
Occasionally == rare - иногда
see doctor - посещать доктора (типа увидеться с доктором)
on top of that - сверх этого (напр. сверх дохода)
master's degree - научная степень (напр. Аспирант)
lobby - хол
work on - работать над
I'm thinking - "я обдумываю"
	(можно употребить в Continues временах)

expectancy == expectance - ожидание(ия) [noun]
penniless - безденежный
household - семейство, домашнее хозяйство
goods - товары
	household goods - хозяйственные товары
noodle - лапша, олух

over there - вон там
take (smth) out - достать (что-то), вынуть
pull down - сносить (дома), сбрасывать

in advance - заранее
prevent - предотвращать
cheer (smbd) up - веселить кого-то?
plait - коса волос
to be good at - быть хорошим в чем-то
deep sleep == crash out - отрубаться, заснуть
cheerful - радостный
yell - вопль, вопить
have a night out - иметь ночную прогулку
unwind == relax
go for work

правило, глаголы с играми:
	play + team game
	go + -ing
	do + activity (yoga, gymnastics)
	исключения: do boxing, do snowboarding == go snowboarding

I'm into (smth-ing) - быть увлеченным чем-то (== I'm interested in)
amateur - любитель
shin pads - щитки на голень
	shin - голень
	pad - щиток
ski pole - лыжная палка
pole - палка, столб
	
pad - набивка (padding), тампон, подушечка
loose-fitting - свободная одежда/чехол
trainers == sneakers - кросовки
pitch - шаг (промежуток между, уровень); какая-то площадка
peny == pence
yen == yens
fraction - дроби

Чтение чисел:
	406 == four hundred AND six (AND читается ТОЛЬКО после СОТЕН, после тысяч и т.д. - НЕТ)
	$9.40 == nine dollars forty
	1/4 - a quarter == one quarter (a == one)
	3/4 - three quarters
	2/3 - two thirds
	7/8 - seven eights
	12 1/2 - twelve and a half
	12 1/6 - twelve and one sixths
	1/9 - a ninth
	6.2 - six point two
	1405 - тысячи НЕЛЬЗЯ называть почастям как даты (14 и 5)
	1405 - one thousand four hundred and five
	
	15/07/94:
		1. the 15th of July, 1994
		2. July the 15th. 1994
	2002:
		1. 2 thousand and 2
		2. 10 oh (оу) 2
		3. 20 zero 2 (вариант USA)
		
	Phone numbers:
		01865-556800 - называть числа по порядку
		17777 - one double seven double seven (для пар чисел)

Правило. Время только 12 часовое. a.m. и p.m
		
laugh - noun || verb
laughter - noun

ward == district
anniversary - годовщина/юбилей
herd of - слышать о (чем-то)
boasted - хвастался
tepee == wigwam
beat - удар, бить, разбитый
on train/bus/airplane - для транспорта
costly == expensive - дорогой
horrid - страшный
arrogant - высокомерный
take over - взять, захватить

sunbathing - загорают
	sunbath - солнечная ванна
sausage (соуседж) - колбасы
palette - палитра
masterpiece - шедевр
sketch - эскиз, набросок

draw - любое рисование
paint - рисование ТОЛЬКО кистью

lambs - ягнята
godfather - крестный отец
terrific - пугающий
stared in it - снимался в этом (кино...)
	star
only son - единственный сын (в семье)

thoroughly (сзароли) - полностью
	thorough - полный
apart - отдельно, в сторону
mistress - хозяйка/женщина; любовница (редко?)
influenza - грипп
eyesight - зрение
wound - рана, ранить
encourage - поощрять, награждать?
farewell - прощание
futility - бесполезность, тщетность

правило:
	... FOR five month
	... FOR six weeks
	... DURING the night
	... DURING the breakfast
	WHILE I was getting ready, I ...
	I met my wife WHILE I was at university.

The meeting lasted from one to three. — Встреча продолжалась с часу до трёх.

narration - повествование
operating / surgical coat - докторский халат
gown - халат, мантия, одевать
injections/nyxis - укол (мед.)
stab - удар ножом, укол чем-то


redemption - выкуп, искупление

to be allowed to (== can) - разрешать что-то
Am I allowed to monetize videos or games that I don’t have access to?
I am allowed to ...

Сокращения:
have to == have got to == gotta - разговорный вариант
	I gotta see a doctor.
want to == wanna
	I don't wanna be no nuisance woman.
gonna - going to
	I'm gonna put a new motor in it.

oversleep - заспаться
from time to time - время от времени
tightrope - натянутая веревка/канат
deaf - глухая


put on weight - набрать вес (потолстеть)
make someone think - заставить кого-то подумать
I don't think we should


Ответ на You must/must not:
	Yes, I will
	No, I won't
	
admission - вход, приём куда-то (в ВУЗ, на вечеринку)
	admission fee — вступительный взнос
tag - бэйджик
tray - поднос
southern - живущий на юге

(to be) in charge of Ving == responsible for - обязан что-то делать (ответственнен)
	I was in charge of logistics on the my expedition.
	
negotiation - переговоры
revelation == eye-opener - откровение
actually - на самом деле, как ни странно

smart - сильная боль, горе (главное значение), толковый, опрятный, умный, сильная боль
nowadays - наши дни
suitable - пригодный
bow - гнуть, наклонять; поклон
	bow to - куму-то

hospitality - гостепреимство
widely common - широко распостраненный
neatly - аккуратно
commonly - обычно
It's not of peace of cake - это не просто сделать
essential - необходимый
saying - поговорка
violate - нарушать
show off == boast
see out - провожать
have (people) over == invite (people)
starter - закуска, snack - больше как перекус?
main course - главное блюдо
beverages - оперетив
rest - остаток, оставаться
pork - свинина

for side - на гарнир
side dish - гарнир

the worries of everyday life seem small - уменьшаются повседневные тревоги
seem small - кажутся маленьким

recipe (рэсипи) - рецепт
right away == right now
Would you mind - Вы не возражаете?

Ещё одно будущее время:
	(вопрос сделать нельзя, это НЕ модальный глагол)
	I might move to Minsk. - Я может быть поеду в Минск.

nil == zero (брит.)
catch plane, catch taxi, catch bus - сесть в транспорт
get in the truc - сесть в грузовик
omit == miss - пропускать

realize - понять, реализовать

offence == offense - правонарушение, оскорбление
bring over - переубедить; перенести (в другое место)


elderly - пожилой
spinster - прядильщица

Про масло:
	butter - то что намазывают
	oil - жидкое
	
leave a job - уволиться с работы
fire - увольнять кого-то за что-то
vocation - призвание, профессия
on vacation - в отпуске
I am on sick leave - Я на больничном

gulf - залив
guff - болтавня (свой пример: заливать)

now on - с теперьшнего момента
hop on - запрыгивать (напр. в транспорт)
facing the front - по направлению вперёд (напр. седенья в поезде)
smooth - гладко, без проблем
call out - громко выкрикивать
eastbound - двигающийся на восток
give a hand == help
pour - наливать
repetition - повторение
spare - запаска, запасной, запасать

hight - рост

Пишутся с -ing после preposition:
for
at
to	+ Ving
in
on

Give it to her.
Listen to him.

Правило in/at/on в пространстве:
(inside a place)
in - внутри чего-то
	work in an office
	in the south of England
	potters in the garden
	lots of shops in the airport
(at point)
at - положение в точке
	at home, at house
	at the cinema, case at the office,
	arrived at the airport
(on surface)
on - положение на поверхности
	on page, on the left (about road),
	on the wall, on the third floor
	
evolve = develop

Эпохи:
before Christ (BC or B.C.)
anno Domini (AD or A.D.)

plain food - постная еда
filling - что-то заполняющее: сытная еда, начинка
topping - что-то сверху: начинка сверху, вздымающийся, верхушка, челка
oatmeal - овсяная крупа
	oatmeal porridge - овсяная каша
	porridge - овсяная каша
eel - угорь
squid - кальмар
herring - сельдь
salmon - лосось
shrimp - креветка
tuna - тунец
junk food - вредная еда
curry - карри или блюдо с карри
oyster - устрица

span - небольшой предмет, размер, расстояние, сфера деятельности

get fit - подгонка
ointment - мазь
cloakroom - раздевалка
	cloak - плащ, мантия, личина
change-room - примерочная
household - домочадцы
reclaim - перевоспитание, перевоспитывать
	claim - требовать
	
How would you like the money? - какими купюрами отдать тебе деньги?

try out - проверять, пробовать
clear up - выяснять, прояснять/пояснять

Разница this и that в разговорном стирается.

Заголовки новостей:
	Газетные заголовок - употребляются в Present Simple
	TV заголовок - употребляются в Present Perfect
	
floods - наводнение
	flood - поток
knoked out - нокаут
sink - тонуть
hairstyle - прическа
widespread - обширный, широко распостраненный
lay-off - остановка производства, забастовка, увольнение из-за остановки производства
labour - труд в том числе по принуждению
elect - избирать
resign - уходить в отставку
company - читается кАмпани

air hostess - борт проводница
flight attendant - борт проводник

правило like/as


hardship - трудность
Who will you talk to? - С кем ты поговоришь?
How are you doing? == How are you?
time clauses - это as soon as, (un)till и тд
either - в конце предложения значит "также"
quit - уволиться самому (уйти с работы)

speak to - обычно для официальных разговоров
tell to - обычно не официальная (болтать)

naughty - капризный
put up with - смириться с
widower - вдовец
just in case - на всякий случай
desk - рабочий стол

I am phoning about (smth) - я звоню по поводу
get back to - перезвонить

discount of/at 2% - скидка на 2%
allow discount - предлагать скидку

trapeze artist - воздушный гимнаст
lack of
head over heels - вверх тормашками

take up (courses/smth) - заниматься курсами/чем-то == do (smth) - делать курсы

hand out - раздать
hand in - собрать

hand down == pass down - передать по наследству
girders - балка
wear and tear == depreciation - усушка и утряска / износ
come across == meet
safe rope - страховочная веревка
carry on == go on
put up (with) - смириться с
take away - убирать
idiomatic - переносный (напр. смысл)
literal - дословный


inanimate - неживой
miss you - скучаю по тебе

после них to не нужно:
	I would rather ... - лучше бы я ... (с I)
	You had better ... - лучше бы ты ... (с you/he и т.д.)

that's it == that's all - это всё! (конец)

ripe - спелый
soil == ground - почва
adore - обожать


proverb == saying - пословицы
submission - подчинение
I'm at Alex house - я у Алекса
fluid == liquid
Let's == let us
embassy - посольство
jigsaw - пазл, лобзик
windfall - неожиданный доход
tempt - соблазн
tempting - заманчиво
solicitor - юрист консультант
sanity - здравый ум
ceaseless (сислес) == endless
	cease - прекращать
hounding - преследование
	hound - преследовать
go on spending spree - тратить деньги
	spending spree - не глагол!
dump - хоронить, сбрасывать/сваливать
bury (бэри) - хоронить/погребать
withdraw - снять деньги, брать назад

superb - суперский
astonish - удивлять
	astonishment - удивление
	astonishing - удивленный
hilarious == funny
thrilled - возбужденный
cross == furious
shelter - приют
housing == organization
conscience - совесть, убеждение, сознание
cross - крест
refugees - беженцы
	refugee
drought - засуха
disillusioned - расстроенный, разочарованный


Правило: Должен быть сделать (probability, possibility)
0. Сама вероятность выражается через:
	must 100% вероятность события (примерная)
	might 80%
	may 70%
	could 60%
1. Present
	He must be at work. - Он должно быть на работе.
2. Continues
	must/could/may/might + be + Ving
	She could be having a shower. - Должно быть (сейчас) она принимает душ.
	He might be coming.
3. Past (have после модальных)
	... + must/may... + have + V3(ed) + ...
	You + must + have + met my brother. - должно быть ты встречал моего брата?
	Примечание: have не меняется на has с he/she/it
4. Отрицание
	В отрицательных ТОЛЬКО одно can't - для всех: must/may и т.д.
	He can't be at work.

route taxi - маршрутное такси
meantime - тем временем
resentment - негодование
get a life - попробуй жить! живи! будь активнее в жизни!
pull yourself together - собирались
soaking wet - промокший насквозь
crutches - костыли

get in touch == keep in touch
offensive - оскорбительный

Правило: Дача согласие/несогласия
	I like ice-cream. - So do I. (я тоже)
	I don't like ice-cream. - Neither do I. (я тоже нет)
	
	I am a teacher. - So am I. (я тоже)
	I am not a teacher. - Neither am I. (я тоже нет)
	
	I like ice-cream. - I don't. или But I don't.
	I don't like. - I do. или But I do.
	
	I have got BMW.
		+ so have I
		- (But) I haven't
		
	I have never seen the sea.
		+ Neither have I
		- But I have
		
	I can't drive.
		+ Neither can I.
		- (But) I can.
	
	Универсальные ответы, могут заменять то что выше (разговорный вариант):
		My too. - Я тоже.
		My neither. - Я тоже нет.
	
Из текста о внешности:
	bring up - воспитывать
	up bringing - воспитание
	crows feet - гусиные лапки (морщинки)
	forensic artist - судебный художник
	nerve racking - нервно
	showed up - показать
	warehouse - склад
	drafting board - доска для рисования
	jaw - подбородок (нижняя челюсть)
	chin - подбородок (на месте бороды)
	protrude (vb) - выдвигать вперед
	prominent (adj) - выступающая (вперед)
	kind of - слово-паразит в США, перевод: "вроде как" - I kind of have a ...


Handy capped == disabled - недееспособный, инвалид (вежливое обращение в отличии от invalid)
craze - мания
reckon - подсчитывать (второе значение)
I can't bear it. - Я не могу это выносить
	bear - нести, относится
	How does your story bear on this case? — Какое отношение имеет ваша история к данному случаю?
ask for ... - просить о ...

chop - резать на куски, рубить
thigh - бедро
cello (селоу) == violoncello - виолончель
sort of == some how - вроде как, как-то?
	I'm sort of like of football. - Я в какой-то степени люблю футблов.
scholarship - стипендия на образование
town hall == city hall - администрация района
traffic lights - светофор
estate - имущество, поместье/имение
engines == cars - иногда заменяет слово cars
shopping spree == spending spree???


ribbon - лента
crayon - цветной карандаш, мелок
pecan - орех "пекан"
consists of ... - состоит из


hair do == hair style
far too much/many - даже слишком много
as much/many as - также много как (используется при сравнении)
	I have sth as much/many as you.
neglected - заброшенный
	neglect - пренебрежении

правило:
indirect question:
	Для построения: вопрос + whether или if + прямой порядок слов (который в этом предложении воспринимается вопросом)
	indirect question - прямой порядок слов в вопросительном предложении (как в Simple времени)
	I would like to know ...
	I wonder ...
	I'm into ...
	+ whether/if
	+ direct word order
	
	(это ВСЁ вопросы на которые НАДО давать ответ)
	I'm into whether he lives in Minsk or ... ?
	I wonder if he works abroad?
	Do you know where he lives? - тоже indirect question
	Can you tell as if there are restaurant?

	Можно просто сказать утвердительное предложение с вопросительной интонацией.
	Как в русском. Это тоже indirect question.


правило:
	There is ...
	There was ...
	There has just been a president in the USA.
	Has there ...
	
kick - пинок ногой
hug - обнимать
arm - вся рука

kiss sth goodbye - махнуть рукой
hit the roof == be furious
kick the habit == give up habit - бросить привычку

deli - гастроном
couch potato - диванный картофель
No way! - ни за что
kind of ... - вроде того
anything good on tonight - что-нибудь хорошего сегодня ночью

What's on (TV/cinema/theater) - часть в скобках опускается

Dunno - don't know
string - нить, шнурок, струна и т.д.
floss - нить, пух
dental floss - зубная нить

What are you up to? - что ты будешь делать?

правило:
indirect (reported) speech == reported speech - косвенная речь (в архиве)
	Present -> Past
	Past -> Past Perfect
	will/can -> would/could
	should/might/could -> should/might/could
	Если есть when/which/what/... то они становятся на место if/whether, есть нету, то that и его можно опустить

правило:
complex object
	I want you to ...
	I beg you to be here.
	I ask him to ...
	The postman told me _not_ to sign. (отрицание)
	
groom == bridegroom - жених, мужчина
mutual - взаимный
mutual understanding - взаимное понимание
have a baby - рождать ребенка
cot - детская краватка
midwife - окушерка
mourners - люди присутствующие на похоронах
coffin - гроб
bouquet == bunch
get past - пройти
aid

---------------------------------Незаконченный upper

из Гарри Поттера 3
	orphan - сирота
		orphanage - приют сирот, сиротство
	neffy == nephew (ласковое)
	Whatsoever - любой, никакой
	On the loose - на свободе
	go rigid - окаменеть
		rigid - жесткий
	to have a fit == faint - чувствовать плохо, падать в обморок
	Divination == prediction
	Oaf == awkward
	brute == beast
	repel - отгонять
	Linger - медлить
	Limb - конечности
	Peaky - изможденный
	Foulest == disgusting
		Foul - грязный
	betray
	sack == fire
	strut about - расхаживать хвастаясь
		strut - хвастаться
	Crikey - оба на
	mercy == kindness
	shriek == yell
	shack - хижина
	spine - хребет

conceal (консил) - скрывать
	council (коэнсэл) - совет
inferiority - низкое качество
gear - механизм
persevere - упорствовать
overdraw - превысить кредит/что-то
overdue - просроченный, опаздывающий
receipt (рисит) - квитанция
	recipe (ресипи) - рецепт
carrot - морковь

из О школах
	needle - иголка, шить
	
из Braveheart
	noble - дворянин
	shank - нога, голень, вести
	truce - перемирие
	page - паж
	shire - графство, жители графства
	succeed - наследовать
	commoner - член общества, простолюдин
	lad - мальчик
	hit back - давать сдачи
	nah (наэ) - нет
	da == десткое dad
	benediction - благословение
	remedy - исправлять, лекарство
	lift up - воодушевлять
	countenance - одобрять, выражение лица, спокойствие
	supervise - смотреть
	rival - соперник
	conceive - понимать
	all along - всегда
	grovel - ползать
	grant - дарить
	reluctant - неохотный
	uproot - вырывать с корнем
	reinstation == reinstatement - восстановление
	breed - племя, род
	fetch - достать что-то
	contender - претендент
	lull - временный перерыв, успокаивать
	aye (аи) - утвердительный ответ
	shaky - трясущийся
	work up - делать что-то
	raise - растить, поднимать
	lassie - девчонка
	thou - ты
	thee - тебе, тебя, тобой
	decree - декрет
	rigid - жесткий
	leniency - мягкость/снисходительность
	scrapper - драчун
	glen - горная долина
	garrison - гарнизон
	brigand - бандит
	quell - подавлять, успокаивать
	convene - созывать
	outnumber - превосходить численно
	embrace - воспользоваться, обнимать
	condemn - порицать, приговаривать к, обрекать
	ruthless - безжалостный
        ruth - сочувствие
	avenge of - отомстить за
	avenge on - отомстить (кому-то)
	cavalry - кавалерия
	spear - копье, пронзать
	flee - убегать
	thy - твой
	homage - почтение
	arse - зад
	foregone - прошлый
	nonetheless - несмотря на
	live up to - оправдывать надеждый, жить по принципам, быть достойным
	hereditary - наследственный
	outmatch - превосходить
	cordial - сердечный
	flank - бок, боковой, быть сбоку
	insolent - высокомерный
	loose - свободный, отпускать тетиву
	infantry - пехота
	inasmuch as - так как
	squabble - мелкая сора
	allegiance - верность
	conscription - воинская повинность
	mere - всего лишь, болото
	barn - амбар
	heathen - язычник
	bribe - подкуп
	ruse - уловка, прием
	upstart - выскочка, вскакивать
	embroidery - вышивание
	tuck - поджать
	slaughter - забой, убой
	rot - гниение, гнить
	prevail - победить
	replenishes
		replenish - пополнять
	shepherd - пастух
	renowned - знаменитый
	jeopardy - опасность
	wage - расплата
	bid - предложение цены
		the highest bid
	pledge - залог
	nest - гнездо
	scheming - замышляющий
		scheme - интрига, замышлять, план
	martyr - мученик
	deceive - обманывать
	taint - оттенок (негативный), пятно, придавать оттенок
	treason - предательство
	purify - очищать
	morrow - завтра
	numb - онемение, вызывать онемение
	endorsement - одобрение
	
из A fog in santone
	overcoat == coat
	wanly - бледно, изнуренно
	crooked - согнутый
		crook - крючок, гнуть
	tangle == tangle up - спутанный, путать/впутывать
	draw - натягивать
	juggle - жонглировать
	absorbedly - увлеченно
	pasteboard - картон, картонный
	sweep - простираться, мести
	contracted - сжатый, контрактный
	linger - медлить, засиживаться
	winding - извилина, извилистый
	malarial - малярийный
	deleterious - вредоносный
	Litmus - лакмус
	recite - декламировать
	thrust - укол, колоть, пихать
	tubercle - мелкий клубень
	ravage - разрушение, разрушать
	thence - оттуда, отсюда
	wooer - поклонник
	dumb - немой
	pathetic - печально-задумчивый
	wraith - являющийся дух
	egregious - абсолютный
	folly - неосмотрительность
	inhale - вдыхать
		hale - здоровье
	exhale - выдыхать
	handy - подручный, сподручный
	beneficent - благотворный
	muriate - соль (соляно-кислая)
	wander - скитаться
	tortuous - извилистый
	gasp - задыхаться, удушье
	garrote - удавка
	rattle - греметь
	strain - напряжение
	phthisical - туберкулезный
	recover - возвращать
	sufficiently - достаточно
	lean - наклон
	freemasonry - братские
	formality - формальная
	introduction - введение
	hemorrhage == haemorrhage - кровотечение
	pulmonary - легочный
	catarrh - простуда
	remark - замечать, замечание
	wheeze - хрипеть
	hack - ударять, рубить
	considerable - важный
	gait - темп, походка
	peg - гвоздь
	entertain - развлекать
	infernal - адский
	respiration - дыхание
	jag - зазубрина, вырезать
	expense - расход, цена
	whisker - борода, усы (кошки)
	line up - строить
	glittering - сверкающий
	bartender - бармен
	sunken - впалый
	mere - всего лишь; озеро, болото, пруд
	chiefly - главным образом
	tedium - скука
	beget - порождать
	chant - песнь
	moist - влажный
	oscillate - качать
	emaciated (имэисиэйт) == exhausted
	contemplative - задумчивый
	peregrination - поездка, изучение
	manifest - явный, обнародовать
	solicitude - забота
	cod - треска, ловить треску
	plunge - погружение
	flange - кромка
	ravine - ущелье
	freshet - поток пресной воды, ручей
	conduct - руководить
	tinkle - звон, звенеть
	breast - грудь (и женская)
	incite - провоцировать
	disremember - забывшийся, забывать
	chap - парень
	jamboree - веселье, пир
	cast off - бросить делать что-то
	moribund - отмирающий
	dissolution - таять, разлагаться
	supreme == main
	desultorily - несвязно
	reck - заботиться
	perceive - понимать
	ante - оплачивать
	marble - мрамор
	ante room - прихожая, приемная
	bestow - дарить
	occupant - жилец
	contiguous - смежный
	saucy - наглый
	discreet - разумный и скромный
	compartment - отделение
	standstill - пауза
	subsequent - последующий
	pulchritude - физическая красота
	engender - возбуждать
	concerning - относительно
	inevitable - неизбежно
	tremble - дрожать
	veil - вуаль
	distinctly - отчетливо
	comeliness - миловидность
	scarcely - едва
	befit - подходить
	Pensive - размышляющий, грустный
	thick - толстый
	effervescent - шипучий, кипучий
	hereditary - наследственный
	foe - противник
	rollicking - бесшабашный
	fortitude - сила духа
	amid - между
	billow - большая волная
	grain - гранула, зерно
	queer - необычный
	fillip - легкий удар, побуждение
	shiver - дрожать
	triturate - растирать в порошок
	endearment - ласка
	exile - изгнание
	furnish - предоставлять
	dwell - обитать
	preceding - предыдущий
	finely - тонко (хорошо)
	whirl - вертеть, вертеться, кружение
	indulgent - снисходительный
	revoyaging - ???
	plumb - вертикальный, отвесный
	spire - шпиль
	enamel - эмаль, эмалировать
	thrice - трижды
	firmament - небесный свод
	prosperous - процветающий
	gaze - пристальный взгляд, пристально глядеть
	antithesis - противоположность
	frown - смотреть неодобрительно
	forehead - лоб
	

swing it == be good at it???
conquer
sustain - поддерживать морально
common sense - здравый смысл
enforcement - принуждение
serfdom - крепостное право

policy - политика поведения (напр. компаний)
politics - политика

last but one - предпоследний
    this is the last but one box to empty
petty - мелкий, мелочный, недалекий человек

из Hacksaw Ridge
    everlasting - вечный, бесконечный
    weary - усталый, утомлять
    fathom - понимание, понимать, морской сажень, измерять глубину
    stumble - спотыкание/спотыкаться, ошибка/ошибаться
    soar - высота, парение, парить
    wait up - дожидаться
    catch up - хватать, ловить, догонять
    slowpoke - тормоз (оскорбление)
    dope - травка (нарк), дурак, сплетня
    ledge - выступ, риф, рейка
    dilated
        dilate - распространяться, странно выражать мысль
    smother - душить, удушье
    egregious - вопиющий, абсолютный
    wallop - лупить, удар
    rejoice - радоваться
        rejoice in - обладать
    tarp - брезент
    suture - наложение шва, накладывать шов
    tourniquet - жгут, турникет
    spruce - нарядный, хвойное дерево
    greasy - засаленный, грязный
    paw - лапа, трогать
    corny - сентиментальный, зерновой
    spurt - прилив, рывок, усиление, делать рывок
    snappy - модный, придирчивый, хрустящий
    gut - кишка
    intestine - кишки
    offal - потроха
    wrecked - разбитый (напр в аварии)
    outta == out of - из, от
    gout - капля, поток, подагра
    fall off - ослабевать
    enlist - вербоваться на военную службу, привлечь на свою сторону
    gaze - пристальный взгляд, уставиться
    deformity
    chowder - густая похлебка
    beanpole - жердь
    pipe down - спустить, сбавить тон
    something off - что-то неправильно, не так
    contradict - противоречить
    garter - подвязка, подвязывать
    chipmunk - бурундук
    henceforth - с этого времени
    chief - вождь
    grinning - ухмыляться
    stalk - стебель
    brisk - живой, оживлять, наряжаться
    bowline - беседочный узел
    knot - узел
    goat - коза, козел
    hustle (vb or noun) - толкотня (основное), спешка
		haste (noun) - спешка
    splinter - разбиваться, осколок
    concubine - любовница, младшая жена
    rifle - винтовка, стрелять из винтовки
    objector - несогласный
    plead - просить
        plea - просьба, заявление
    poke - удар, пинок, толчок, бить
    constitute - составлять
    sty - свинарник
    ease - облегчение, облегчать, вольно
    furlough - увольнение отпуск
    delirious - бредящий
    flaunt - гордо на показ
    contempt - презрение
    contest - спор, оспаривать
    compel - вынуждать
    waive - отказывать (юр), откладывать
    colonel - полковник
    rile - сердить
    chow - жратва
    come off - покидать
    nip - япошка
    stretcher - носилки, растяжка
	triage - сортировка, порядок, плохое кофе
	satchel - ранец
	straight off - сразу
    spout - горлышко, лить
	abdominal - брюшной
	jiffy - миг
	
internship - интернатура
abundance - изобилие
hygiene - гигиена
pedestrian - пешеход

Sebaceous glands - сальные железы
kidney - почка
liver - печень

the other days - some days ago
yeast - дрожжи
fertilizer - удобрение
contest == rivalry - соперничество
state worker - гос. рабочий
Hollow Crown - пустая корона
last - длиться
Barley - петрушка

12 Years a Slave
	Y'all
	shuck - шелуха, очищать от шелухи
	overly - через-мерно
	gracious - милостив
	take into consideration - принимать во внимание
		take into - принимать в
	graciousness - доброта
	circus - круг, площадь
	merry - веселый; оживленный; черешня
	confounding - путать (смешивать), смешивание
	aide - консультант, ответственный сотрудник
	renowned - знаменитый
	practitioner - практикующий
	prestidigitation - показывание фокусов
	thither - там, туда, до тех пор
	procure - добывать, поставлять, поставщик
	sufficient - достаточный
	undeniable - несомненно
	libation - выпивка
	detain - задерживать
	rags - тряпки
	tatter - тряпка, рвать
	gratitude - благодарность
	venture - авантюра
	redeem - выкупать
	line up - выстраиваться в линию
	cast down - расстроен, опущен
	better off - лучше
	cravat - широкий галстук
	carryall - большая сумка
	sturdy - крепкий
	intrusion - вторжение
	pastry - кондитерские изделия, хорошенькая женщина
	splendid == gorgeous, отличный, здорово!
	brawny - крепкий, мускулистый
	snivelling - распускать слюни, всхлипывать
	wench - девка (в плохом смысле)
	fiddle - зуд, надувать, тратить попусту
		fiddle - скрипка, скрипач
	dawdle - лодырь, бездельничать
	carpenter - плотник
	patty - пирожок, котлета
	bushel - бушель, 36.37 л.
	peck - клевать; много, куча; легкий поцелуй
	multitude - толпа
	creek - залив, устье
	latter - последний
	bayou - заболоченные ручей или протока
	fewer - меньше
	diminish - уменьшать
	tub - лоханка, коробка, бак
	raft - плот, ветошь, груда
	timber - лесоматериал
	wailing - вой, плачь
	sorrow - горе
	truckle - раболепствовать
	weep (for) - плачь (о)
	
	offer up - применить, прикинуть оценить
	hearty - сердечный; дружественный
	whosoever - кто бы ни
	flush - прилив, заполненный, приливать
		Make them boards flush.
	yearling's coat
		yearling - первогодка
	better for (someone) - лучше для (кого-то)
	keg - бочонок, желудь
	commence - начинать, начинаться
	putting - толкание
	clapboard - клепка (обшивочная доска)
	bore - скучное занятие, скучный; наскучивать; бурить
		bore for you
	pretence - притворство; предлог; претензия
	overseer - надзиратель
	skulk - красться
		To skulk about in pits - прятаться в ямах
	mindful of - внимательный к, заботливый к
	many stripes
	menfolk - мужчины семьи или соц. группы
	out-pick
	righteous - праведный
	merriment - веселье
	vigor == vigour - сила, энергия
	sundry - различный
		sundries - всякая всячина
	retrieve - вернуть обратно, доставать, извлекать
	roam - бродить, странствовать
	Sabbath - священный день
	consternation - испуг
	lessen - уменьшаться, уменьшать
	timely - своевременный
	Lothario - повеса
	misguided - заблуждающийся, ошибочный
	fidelity - верность, привязанность
	predilection - пристрастие
	peculiarity - специфичность, особенность
	lusty - здоровый, сильный
	concede - уступать; отказываться; предавать
	fuss - суета, возражение
	misbegotten - незаконнорожденный
	scorn - презрение
	whatever - какой бы ни
	fester - отравление, нагноение
	eunuch - евнух
	gory - кровавый; чудовищный
	consign - поручать; передавать
	damnation - проклятие
	smite - бить, карать
	porch - крыльцо, подъезд, веранда, балкон
	whoa - тпру
	beguile - развлекать; отвлекать
	proceeds - доход
	picayune - пустяк
	deposit - отдавать на хранение
	inviolable - нерушимый
	baptize - крестить, нарекать
	hallelujah - аллилуйя
	respite - передышка, дать отсрочку
	frankly - откровенно, публично
	righteousness - справедливость
	baboon - павиан
	assuredly - конечно, несомненно
	misdeed - преступление; ошибка
	gag - затычка, кляп
	covetous - жадный
	welt - рубец, удар
	profound - сильный, абсолютный
	befall - происходить
		befall none - не происходить???
	beseeching - упрашивающий, молящий
	shingle - щепка, дощечка
	accusation - обвинений
	interfere - помехи, мешать; оспаривать
	haste - спешка
	abduction - похищение
	
    hustle (vb or noun) - толкотня (основное), спешка
		haste (noun) - спешка
